Data;H_team;H_Elo_pre;H_Diff;H_Elo_post;Risultato;H_gol;A_gol;Esito;1_prob_elo;X_prob_elo;2_prob_elo;A_team;A_Elo_pre;A_Diff;A_Elo_post
19/10/2019;Juventus;2197;2;2199;2 - 1;2;1;1;80;14;6;Bologna FC;1861;-2;1859
19/10/2019;Lazio Roma;1983;-1;1982;3 - 3;3;3;X;38;29;33;Atalanta;2056;1;2057
19/10/2019;SSC Napoli;2110;1;2111;2 - 0;2;0;1;84;12;4;Hellas Verona;1696;-1;1695
06/10/2019;Inter;2076;-10;2066;1 - 2;1;2;2;34;29;36;Juventus;2187;10;2197
06/10/2019;Torino FC;1963;1;1964;0 - 0;0;0;X;31;29;40;SSC Napoli;2111;-1;2110
06/10/2019;AS Roma;2039;-7;2032;1 - 1;1;1;X;70;18;12;Cagliari Calcio;1830;7;1837
06/10/2019;Bologna FC;1860;1;1861;2 - 2;2;2;X;33;29;38;Lazio Roma;1984;-1;1983
06/10/2019;Atalanta;2053;3;2056;3 - 1;3;1;1;76;16;9;US Lecce;1776;-3;1773
06/10/2019;ACF Fiorentina;1919;5;1924;1 - 0;1;0;1;58;24;18;Udinese Calcio;1821;-5;1816
05/10/2019;Genoa CFC;1801;-8;1793;1 - 2;1;2;2;29;29;43;AC Milan;1968;8;1976
05/10/2019;SPAL 2013 Ferrara;1785;7;1792;1 - 0;1;0;1;46;28;26;Parma Calcio 1913;1785;-7;1778
05/10/2019;Hellas Verona;1678;18;1696;2 - 0;2;0;1;28;28;44;Sampdoria;1854;-18;1836
30/09/2019;Parma Calcio 1913;1772;13;1785;3 - 2;3;2;1;26;27;47;Torino FC;1976;-13;1963
29/09/2019;AC Milan;1991;-23;1968;1 - 3;1;3;2;57;24;19;ACF Fiorentina;1896;23;1919
29/09/2019;SSC Napoli;2116;1;2117;2 - 1;2;1;1;82;13;5;Brescia Calcio;1741;-1;1740
29/09/2019;US Lecce;1782;-6;1776;0 - 1;0;1;2;21;25;53;AS Roma;2040;6;2046
29/09/2019;Lazio Roma;1969;7;1976;4 - 0;4;0;1;65;21;14;Genoa CFC;1808;-7;1801
29/09/2019;Udinese Calcio;1812;9;1821;1 - 0;1;0;1;40;29;31;Bologna FC;1869;-9;1860
29/09/2019;Cagliari Calcio;1836;-6;1830;1 - 1;1;1;X;65;21;14;Hellas Verona;1672;6;1678
28/09/2019;Juventus;2175;2;2177;2 - 0;2;0;1;83;12;5;SPAL 2013 Ferrara;1787;-2;1785
28/09/2019;Sampdoria;1865;-11;1854;1 - 3;1;3;2;26;27;47;Inter;2070;11;2081
28/09/2019;Sassuolo Calcio;1850;-12;1838;1 - 4;1;4;2;25;27;48;Atalanta;2061;12;2073
26/09/2019;Torino FC;1968;8;1976;2 - 1;2;1;1;43;29;29;AC Milan;1999;-8;1991
25/09/2019;AS Roma;2060;-20;2040;0 - 2;0;2;2;48;27;24;Atalanta;2041;20;2061
25/09/2019;Inter;2065;5;2070;1 - 0;1;0;1;57;24;19;Lazio Roma;1974;-5;1969
25/09/2019;SSC Napoli;2134;-18;2116;0 - 1;0;1;2;78;14;7;Cagliari Calcio;1818;18;1836
25/09/2019;ACF Fiorentina;1889;7;1896;2 - 1;2;1;1;48;27;25;Sampdoria;1872;-7;1865
25/09/2019;Genoa CFC;1809;-1;1808;0 - 0;0;0;X;40;29;31;Bologna FC;1868;1;1869
25/09/2019;Parma Calcio 1913;1762;10;1772;1 - 0;1;0;1;35;29;35;Sassuolo Calcio;1860;-10;1850
25/09/2019;SPAL 2013 Ferrara;1808;-21;1787;1 - 3;1;3;2;52;26;22;US Lecce;1761;21;1782
24/09/2019;Brescia Calcio;1744;-3;1741;1 - 2;1;2;2;11;17;72;Juventus;2172;3;2175
24/09/2019;Hellas Verona;1671;1;1672;0 - 0;0;0;X;31;29;40;Udinese Calcio;1813;-1;1812
22/09/2019;Atalanta;2047;-6;2041;2 - 2;2;2;X;65;21;14;ACF Fiorentina;1883;6;1889
22/09/2019;Bologna FC;1876;-8;1868;1 - 2;1;2;2;28;28;44;AS Roma;2052;8;2060
22/09/2019;US Lecce;1767;-6;1761;1 - 4;1;4;2;15;20;65;SSC Napoli;2128;6;2134
22/09/2019;Sampdoria;1861;11;1872;1 - 0;1;0;1;33;29;37;Torino FC;1979;-11;1968
22/09/2019;Lazio Roma;1970;4;1974;2 - 0;2;0;1;69;19;12;Parma Calcio 1913;1766;-4;1762
22/09/2019;Sassuolo Calcio;1849;11;1860;3 - 0;3;0;1;50;27;24;SPAL 2013 Ferrara;1819;-11;1808
21/09/2019;AC Milan;2017;-18;1999;0 - 2;0;2;2;43;29;29;Inter;2047;18;2065
21/09/2019;Juventus;2171;1;2172;2 - 1;2;1;1;87;10;3;Hellas Verona;1672;-1;1671
21/09/2019;Udinese Calcio;1828;-15;1813;0 - 1;0;1;2;58;24;18;Brescia Calcio;1729;15;1744
20/09/2019;Cagliari Calcio;1807;11;1818;3 - 1;3;1;1;45;28;27;Genoa CFC;1820;-11;1809
16/09/2019;Torino FC;1997;-18;1979;1 - 2;1;2;2;73;17;10;US Lecce;1749;18;1767
15/09/2019;Genoa CFC;1826;-6;1820;1 - 2;1;2;2;22;26;52;Atalanta;2071;6;2077
15/09/2019;AS Roma;2042;5;2047;4 - 2;4;2;1;68;19;13;Sassuolo Calcio;1854;-5;1849
15/09/2019;SPAL 2013 Ferrara;1807;12;1819;2 - 1;2;1;1;27;28;45;Lazio Roma;1995;-12;1983
15/09/2019;Hellas Verona;1676;-4;1672;0 - 1;0;1;2;16;22;63;AC Milan;2013;4;2017
15/09/2019;Brescia Calcio;1738;-9;1729;3 - 4;3;4;2;32;29;38;Bologna FC;1867;9;1876
15/09/2019;Parma Calcio 1913;1785;-19;1766;1 - 3;1;3;2;46;28;26;Cagliari Calcio;1788;19;1807
14/09/2019;ACF Fiorentina;1878;5;1883;0 - 0;0;0;X;19;24;58;Juventus;2173;-5;2168
14/09/2019;SSC Napoli;2094;4;2098;2 - 0;2;0;1;72;18;11;Sampdoria;1865;-4;1861
14/09/2019;Inter;2050;3;2053;1 - 0;1;0;1;71;18;11;Udinese Calcio;1831;-3;1828
01/09/2019;Atalanta;2086;-15;2071;2 - 3;2;3;2;58;23;18;Torino FC;1982;15;1997
01/09/2019;Lazio Roma;1997;-2;1995;1 - 1;1;1;X;41;29;30;AS Roma;2040;2;2042
01/09/2019;Cagliari Calcio;1794;-6;1788;1 - 2;1;2;2;22;26;52;Inter;2044;6;2050
01/09/2019;Sassuolo Calcio;1839;15;1854;4 - 1;4;1;1;42;29;30;Sampdoria;1880;-15;1865
01/09/2019;Genoa CFC;1817;9;1826;2 - 1;2;1;1;38;29;32;ACF Fiorentina;1887;-9;1878
01/09/2019;Udinese Calcio;1853;-22;1831;1 - 3;1;3;2;57;24;19;Parma Calcio 1913;1763;22;1785
01/09/2019;US Lecce;1764;-15;1749;0 - 1;0;1;2;58;23;18;Hellas Verona;1661;15;1676
31/08/2019;Juventus;2167;6;2173;4 - 3;4;3;1;54;25;21;SSC Napoli;2100;-6;2094
31/08/2019;AC Milan;2011;2;2013;1 - 0;1;0;1;75;16;9;Brescia Calcio;1740;-2;1738
30/08/2019;Bologna FC;1861;6;1867;1 - 0;1;0;1;52;26;22;SPAL 2013 Ferrara;1813;-6;1807
26/08/2019;Inter;2040;4;2044;4 - 0;4;0;1;75;16;9;US Lecce;1768;-4;1764
25/08/2019;SPAL 2013 Ferrara;1819;-6;1813;2 - 3;2;3;2;21;25;54;Atalanta;2080;6;2086
25/08/2019;Sampdoria;1899;-19;1880;0 - 3;0;3;2;37;29;33;Lazio Roma;1978;19;1997
25/08/2019;Udinese Calcio;1841;12;1853;1 - 0;1;0;1;28;28;44;AC Milan;2023;-12;2011
25/08/2019;AS Roma;2047;-7;2040;3 - 3;3;3;X;72;17;10;Genoa CFC;1810;7;1817
25/08/2019;Torino FC;1985;4;1989;2 - 1;2;1;1;63;22;16;Sassuolo Calcio;1843;-4;1839
25/08/2019;Cagliari Calcio;1809;-15;1794;0 - 1;0;1;2;56;24;19;Brescia Calcio;1725;15;1740
25/08/2019;Hellas Verona;1658;3;1661;1 - 1;1;1;X;26;27;47;Bologna FC;1864;-3;1861
24/08/2019;ACF Fiorentina;1894;-7;1887;3 - 4;3;4;2;26;28;46;SSC Napoli;2093;7;2100
24/08/2019;Parma Calcio 1913;1766;-3;1763;0 - 1;0;1;2;12;19;69;Juventus;2164;3;2167
26/05/2019;Sampdoria;1865;23;1888;2 - 0;2;0;1;17;22;61;Juventus;2187;-23;2164
26/05/2019;Torino FC;1980;11;1991;3 - 1;3;1;1;45;28;27;Lazio Roma;1989;-11;1978
26/05/2019;Atalanta;2076;4;2080;3 - 1;3;1;1;72;17;11;Sassuolo Calcio;1844;-4;1840
26/05/2019;Inter;2037;3;2040;2 - 1;2;1;1;71;18;11;Empoli FC;1813;-3;1810
26/05/2019;SPAL 2013 Ferrara;1827;-8;1819;2 - 3;2;3;2;27;28;45;AC Milan;2015;8;2023
26/05/2019;AS Roma;2045;2;2047;2 - 1;2;1;1;76;15;8;Parma Calcio 1913;1762;-2;1760
26/05/2019;ACF Fiorentina;1899;-5;1894;0 - 0;0;0;X;57;24;19;Genoa CFC;1805;5;1810
26/05/2019;Cagliari Calcio;1818;-13;1805;1 - 2;1;2;2;45;28;27;Udinese Calcio;1828;13;1841
25/05/2019;Bologna FC;1841;14;1855;3 - 2;3;2;1;21;25;54;SSC Napoli;2107;-14;2093
25/05/2019;Frosinone Calcio;1710;-3;1707;0 - 0;0;0;X;49;27;24;Chievo Verona;1688;3;1691
20/05/2019;Lazio Roma;1995;-6;1989;3 - 3;3;3;X;65;21;15;Bologna FC;1835;6;1841
19/05/2019;Juventus;2193;-6;2187;1 - 1;1;1;X;61;23;17;Atalanta;2070;6;2076
19/05/2019;SSC Napoli;2097;10;2107;4 - 1;4;1;1;52;26;22;Inter;2047;-10;2037
19/05/2019;Empoli FC;1790;23;1813;4 - 1;4;1;1;25;27;48;Torino FC;2003;-23;1980
19/05/2019;AC Milan;2012;3;2015;2 - 0;2;0;1;77;15;8;Frosinone Calcio;1713;-3;1710
19/05/2019;Parma Calcio 1913;1750;12;1762;1 - 0;1;0;1;29;29;42;ACF Fiorentina;1911;-12;1899
19/05/2019;Chievo Verona;1686;2;1688;0 - 0;0;0;X;28;28;44;Sampdoria;1867;-2;1865
18/05/2019;Sassuolo Calcio;1841;3;1844;0 - 0;0;0;X;25;27;47;AS Roma;2048;-3;2045
18/05/2019;Udinese Calcio;1820;8;1828;3 - 2;3;2;1;44;28;27;SPAL 2013 Ferrara;1835;-8;1827
18/05/2019;Genoa CFC;1808;-3;1805;1 - 1;1;1;X;45;28;27;Cagliari Calcio;1815;3;1818
13/05/2019;Inter;2045;2;2047;2 - 0;2;0;1;81;13;6;Chievo Verona;1688;-2;1686
13/05/2019;Bologna FC;1825;10;1835;4 - 1;4;1;1;54;25;21;Parma Calcio 1913;1760;-10;1750
12/05/2019;AS Roma;2030;18;2048;2 - 0;2;0;1;28;28;44;Juventus;2211;-18;2193
12/05/2019;SPAL 2013 Ferrara;1841;-6;1835;1 - 2;1;2;2;22;26;52;SSC Napoli;2091;6;2097
12/05/2019;Torino FC;1999;4;2003;3 - 2;3;2;1;64;21;15;Sassuolo Calcio;1845;-4;1841
12/05/2019;Sampdoria;1882;-15;1867;1 - 2;1;2;2;59;23;18;Empoli FC;1775;15;1790
12/05/2019;Frosinone Calcio;1729;-16;1713;1 - 3;1;3;2;38;29;33;Udinese Calcio;1804;16;1820
11/05/2019;ACF Fiorentina;1922;-11;1911;0 - 1;0;1;2;37;29;33;AC Milan;2001;11;2012
11/05/2019;Atalanta;2083;2;2085;2 - 1;2;1;1;75;16;9;Genoa CFC;1810;-2;1808
11/05/2019;Cagliari Calcio;1824;-9;1815;1 - 2;1;2;2;31;29;40;Lazio Roma;1971;9;1980
06/05/2019;AC Milan;1998;3;2001;2 - 1;2;1;1;66;20;14;Bologna FC;1828;-3;1825
05/05/2019;Lazio Roma;1987;-16;1971;1 - 3;1;3;2;37;29;33;Atalanta;2067;16;2083
05/05/2019;SSC Napoli;2089;2;2091;2 - 1;2;1;1;75;16;9;Cagliari Calcio;1826;-2;1824
05/05/2019;Genoa CFC;1807;3;1810;1 - 1;1;1;X;24;27;49;AS Roma;2033;-3;2030
05/05/2019;Empoli FC;1763;12;1775;1 - 0;1;0;1;29;28;43;ACF Fiorentina;1934;-12;1922
05/05/2019;Parma Calcio 1913;1759;1;1760;3 - 3;3;3;X;33;29;38;Sampdoria;1883;-1;1882
05/05/2019;Sassuolo Calcio;1851;-6;1845;2 - 2;2;2;X;61;22;16;Frosinone Calcio;1723;6;1729
04/05/2019;Udinese Calcio;1800;4;1804;0 - 0;0;0;X;22;26;52;Inter;2049;-4;2045
04/05/2019;Chievo Verona;1706;-18;1688;0 - 4;0;4;2;34;29;37;SPAL 2013 Ferrara;1823;18;1841
03/05/2019;Juventus;2218;-7;2211;1 - 1;1;1;X;71;18;11;Torino FC;1992;7;1999
29/04/2019;Atalanta;2064;3;2067;2 - 0;2;0;1;74;16;9;Udinese Calcio;1803;-3;1800
29/04/2019;ACF Fiorentina;1950;-16;1934;0 - 1;0;1;2;60;23;17;Sassuolo Calcio;1835;16;1851
28/04/2019;Torino FC;1980;12;1992;2 - 0;2;0;1;43;29;29;AC Milan;2010;-12;1998
28/04/2019;Sampdoria;1894;-11;1883;1 - 2;1;2;2;37;29;33;Lazio Roma;1976;11;1987
28/04/2019;Frosinone Calcio;1729;-6;1723;0 - 2;0;2;2;15;21;64;SSC Napoli;2083;6;2089
28/04/2019;SPAL 2013 Ferrara;1826;-3;1823;1 - 1;1;1;X;49;27;24;Genoa CFC;1804;3;1807
28/04/2019;Chievo Verona;1707;-1;1706;1 - 1;1;1;X;40;29;31;Parma Calcio 1913;1758;1;1759
27/04/2019;Inter;2047;2;2049;1 - 1;1;1;X;28;28;43;Juventus;2220;-2;2218
27/04/2019;AS Roma;2028;5;2033;3 - 0;3;0;1;69;19;12;Cagliari Calcio;1831;-5;1826
27/04/2019;Bologna FC;1819;9;1828;3 - 1;3;1;1;52;26;22;Empoli FC;1772;-9;1763
22/04/2019;SSC Napoli;2097;-14;2083;1 - 2;1;2;2;52;26;22;Atalanta;2045;14;2059
20/04/2019;Juventus;2218;2;2220;2 - 1;2;1;1;74;16;9;ACF Fiorentina;1957;-2;1955
20/04/2019;Inter;2050;-3;2047;1 - 1;1;1;X;49;27;24;AS Roma;2025;3;2028
20/04/2019;Genoa CFC;1812;-8;1804;0 - 1;0;1;2;30;29;42;Torino FC;1972;8;1980
20/04/2019;Parma Calcio 1913;1753;5;1758;1 - 1;1;1;X;20;24;55;AC Milan;2029;-5;2024
20/04/2019;Bologna FC;1801;18;1819;3 - 0;3;0;1;34;29;36;Sampdoria;1912;-18;1894
20/04/2019;Lazio Roma;1980;-18;1962;1 - 2;1;2;2;77;15;8;Chievo Verona;1689;18;1707
20/04/2019;Udinese Calcio;1805;-2;1803;1 - 1;1;1;X;43;29;28;Sassuolo Calcio;1833;2;1835
20/04/2019;Empoli FC;1790;-18;1772;2 - 4;2;4;2;44;28;28;SPAL 2013 Ferrara;1808;18;1826
20/04/2019;Cagliari Calcio;1826;5;1831;1 - 0;1;0;1;57;24;19;Frosinone Calcio;1734;-5;1729
17/04/2019;Lazio Roma;1975;5;1980;2 - 0;2;0;1;65;20;14;Udinese Calcio;1810;-5;1805
15/04/2019;Atalanta;2053;-8;2045;0 - 0;0;0;X;75;16;9;Empoli FC;1782;8;1790
14/04/2019;Chievo Verona;1693;-4;1689;1 - 3;1;3;2;11;18;71;SSC Napoli;2109;4;2113
14/04/2019;Torino FC;1978;-6;1972;1 - 1;1;1;X;65;21;15;Cagliari Calcio;1820;6;1826
14/04/2019;Frosinone Calcio;1741;-7;1734;1 - 3;1;3;2;18;23;58;Inter;2043;7;2050
14/04/2019;ACF Fiorentina;1963;-6;1957;0 - 0;0;0;X;66;20;14;Bologna FC;1795;6;1801
14/04/2019;Sampdoria;1904;8;1912;2 - 0;2;0;1;56;24;19;Genoa CFC;1820;-8;1812
14/04/2019;Sassuolo Calcio;1838;-5;1833;0 - 0;0;0;X;57;24;19;Parma Calcio 1913;1748;5;1753
13/04/2019;SPAL 2013 Ferrara;1790;18;1808;2 - 1;2;1;1;9;16;75;Juventus;2260;-18;2242
13/04/2019;AC Milan;2023;6;2029;1 - 0;1;0;1;51;26;23;Lazio Roma;1981;-6;1975
13/04/2019;AS Roma;2022;3;2025;1 - 0;1;0;1;70;18;12;Udinese Calcio;1813;-3;1810
08/04/2019;Bologna FC;1786;9;1795;3 - 0;3;0;1;56;24;19;Chievo Verona;1702;-9;1693
07/04/2019;Inter;2046;-3;2043;0 - 0;0;0;X;46;28;26;Atalanta;2050;3;2053
07/04/2019;SSC Napoli;2132;-8;2124;1 - 1;1;1;X;79;14;7;Genoa CFC;1812;8;1820
07/04/2019;Lazio Roma;1987;-6;1981;2 - 2;2;2;X;64;21;15;Sassuolo Calcio;1832;6;1838
07/04/2019;ACF Fiorentina;1981;-18;1963;0 - 1;0;1;2;74;16;9;Frosinone Calcio;1723;18;1741
07/04/2019;Cagliari Calcio;1813;7;1820;2 - 1;2;1;1;48;27;25;SPAL 2013 Ferrara;1797;-7;1790
07/04/2019;Udinese Calcio;1806;7;1813;3 - 2;3;2;1;48;27;25;Empoli FC;1789;-7;1782
06/04/2019;Juventus;2260;3;2263;2 - 1;2;1;1;72;17;11;AC Milan;2026;-3;2023
06/04/2019;Sampdoria;1914;-10;1904;0 - 1;0;1;2;35;29;35;AS Roma;2012;10;2022
06/04/2019;Parma Calcio 1913;1744;4;1748;0 - 0;0;0;X;23;26;51;Torino FC;1982;-4;1978
04/04/2019;Atalanta;2046;4;2050;4 - 1;4;1;1;74;16;10;Bologna FC;1790;-4;1786
04/04/2019;Sassuolo Calcio;1824;8;1832;4 - 0;4;0;1;60;23;17;Chievo Verona;1710;-8;1702
03/04/2019;AS Roma;2016;-4;2012;2 - 2;2;2;X;51;26;23;ACF Fiorentina;1977;4;1981
03/04/2019;Empoli FC;1772;17;1789;2 - 1;2;1;1;14;20;67;SSC Napoli;2149;-17;2132
03/04/2019;Torino FC;1976;6;1982;2 - 1;2;1;1;53;26;22;Sampdoria;1920;-6;1914
03/04/2019;Genoa CFC;1825;-13;1812;0 - 4;0;4;2;25;27;47;Inter;2033;13;2046
03/04/2019;SPAL 2013 Ferrara;1784;13;1797;1 - 0;1;0;1;25;27;48;Lazio Roma;2000;-13;1987
03/04/2019;Frosinone Calcio;1715;8;1723;3 - 2;3;2;1;42;29;29;Parma Calcio 1913;1752;-8;1744
02/04/2019;Cagliari Calcio;1817;-4;1813;0 - 2;0;2;2;10;17;73;Juventus;2256;4;2260
02/04/2019;AC Milan;2033;-7;2026;1 - 1;1;1;X;72;17;11;Udinese Calcio;1799;7;1806
31/03/2019;AS Roma;2034;-18;2016;1 - 4;1;4;2;36;29;35;SSC Napoli;2131;18;2149
31/03/2019;Inter;2047;-14;2033;0 - 1;0;1;2;53;25;21;Lazio Roma;1986;14;2000
31/03/2019;ACF Fiorentina;1980;-3;1977;1 - 1;1;1;X;47;28;25;Torino FC;1973;3;1976
31/03/2019;Parma Calcio 1913;1760;-8;1752;1 - 3;1;3;2;20;24;56;Atalanta;2038;8;2046
31/03/2019;Bologna FC;1781;9;1790;2 - 1;2;1;1;40;29;31;Sassuolo Calcio;1833;-9;1824
31/03/2019;Frosinone Calcio;1727;-12;1715;0 - 1;0;1;2;41;29;30;SPAL 2013 Ferrara;1772;12;1784
30/03/2019;Juventus;2255;1;2256;1 - 0;1;0;1;86;11;3;Empoli FC;1773;-1;1772
30/03/2019;Sampdoria;1909;11;1920;1 - 0;1;0;1;32;29;39;AC Milan;2044;-11;2033
30/03/2019;Udinese Calcio;1786;13;1799;2 - 0;2;0;1;40;29;31;Genoa CFC;1838;-13;1825
29/03/2019;Chievo Verona;1729;-19;1710;0 - 3;0;3;2;39;29;32;Cagliari Calcio;1798;19;1817
17/03/2019;Genoa CFC;1811;27;1838;2 - 0;2;0;1;9;15;76;Juventus;2282;-27;2255
17/03/2019;AC Milan;2057;-13;2044;2 - 3;2;3;2;49;27;24;Inter;2034;13;2047
17/03/2019;SSC Napoli;2129;2;2131;4 - 2;4;2;1;80;14;6;Udinese Calcio;1788;-2;1786
17/03/2019;Atalanta;2046;-8;2038;1 - 1;1;1;X;79;14;7;Chievo Verona;1721;8;1729
17/03/2019;Lazio Roma;1981;5;1986;4 - 1;4;1;1;70;18;11;Parma Calcio 1913;1765;-5;1760
17/03/2019;Empoli FC;1767;6;1773;2 - 1;2;1;1;50;27;23;Frosinone Calcio;1733;-6;1727
16/03/2019;SPAL 2013 Ferrara;1757;15;1772;2 - 1;2;1;1;19;24;57;AS Roma;2049;-15;2034
16/03/2019;Torino FC;1990;-17;1973;2 - 3;2;3;2;71;18;11;Bologna FC;1764;17;1781
16/03/2019;Sassuolo Calcio;1851;-18;1833;3 - 5;3;5;2;42;29;30;Sampdoria;1891;18;1909
15/03/2019;Cagliari Calcio;1785;13;1798;2 - 1;2;1;1;25;27;47;ACF Fiorentina;1993;-13;1980
11/03/2019;AS Roma;2047;2;2049;2 - 1;2;1;1;76;16;9;Empoli FC;1769;-2;1767
10/03/2019;Sassuolo Calcio;1846;5;1851;1 - 1;1;1;X;18;23;59;SSC Napoli;2155;-5;2150
10/03/2019;ACF Fiorentina;1996;-3;1993;1 - 1;1;1;X;48;27;25;Lazio Roma;1978;3;1981
10/03/2019;Sampdoria;1900;-9;1891;1 - 2;1;2;2;32;29;39;Atalanta;2037;9;2046
10/03/2019;Inter;2047;3;2050;2 - 0;2;0;1;76;15;8;SPAL 2013 Ferrara;1760;-3;1757
10/03/2019;Frosinone Calcio;1739;-6;1733;1 - 2;1;2;2;22;26;52;Torino FC;1984;6;1990
10/03/2019;Bologna FC;1751;13;1764;2 - 0;2;0;1;41;29;30;Cagliari Calcio;1798;-13;1785
09/03/2019;Chievo Verona;1725;-4;1721;1 - 2;1;2;2;17;22;61;AC Milan;2053;4;2057
09/03/2019;Parma Calcio 1913;1756;9;1765;1 - 0;1;0;1;39;29;32;Genoa CFC;1820;-9;1811
08/03/2019;Juventus;2267;1;2268;4 - 1;4;1;1;86;11;3;Udinese Calcio;1789;-1;1788
03/03/2019;SSC Napoli;2155;-10;2145;1 - 2;1;2;2;35;29;35;Juventus;2257;10;2267
03/03/2019;Atalanta;2027;10;2037;3 - 1;3;1;1;49;27;24;ACF Fiorentina;2006;-10;1996
03/03/2019;Torino FC;1980;4;1984;3 - 0;3;0;1;74;17;10;Chievo Verona;1729;-4;1725
03/03/2019;SPAL 2013 Ferrara;1769;-9;1760;1 - 2;1;2;2;33;29;38;Sampdoria;1891;9;1900
03/03/2019;Genoa CFC;1825;-5;1820;0 - 0;0;0;X;57;24;19;Frosinone Calcio;1734;5;1739
03/03/2019;Udinese Calcio;1782;7;1789;2 - 1;2;1;1;49;27;24;Bologna FC;1758;-7;1751
02/03/2019;Lazio Roma;1960;18;1978;3 - 0;3;0;1;33;29;37;AS Roma;2079;-18;2061
02/03/2019;AC Milan;2050;3;2053;1 - 0;1;0;1;69;19;12;Sassuolo Calcio;1849;-3;1846
02/03/2019;Empoli FC;1772;-3;1769;3 - 3;3;3;X;48;27;24;Parma Calcio 1913;1753;3;1756
01/03/2019;Cagliari Calcio;1783;15;1798;2 - 1;2;1;1;20;25;55;Inter;2058;-15;2043
24/02/2019;ACF Fiorentina;2009;-1;2008;3 - 3;3;3;X;41;29;30;Inter;2057;1;2058
24/02/2019;Bologna FC;1760;-2;1758;0 - 1;0;1;2;8;15;77;Juventus;2255;2;2257
24/02/2019;Parma Calcio 1913;1759;-6;1753;0 - 4;0;4;2;13;19;68;SSC Napoli;2149;6;2155
24/02/2019;Sampdoria;1886;5;1891;1 - 0;1;0;1;58;24;18;Cagliari Calcio;1788;-5;1783
24/02/2019;Sassuolo Calcio;1854;-5;1849;1 - 1;1;1;X;57;24;19;SPAL 2013 Ferrara;1764;5;1769
24/02/2019;Chievo Verona;1729;0;1729;0 - 0;0;0;X;36;29;35;Genoa CFC;1825;0;1825
23/02/2019;Torino FC;1966;14;1980;2 - 0;2;0;1;38;29;33;Atalanta;2039;-14;2025
23/02/2019;Frosinone Calcio;1738;-4;1734;2 - 3;2;3;2;16;22;63;AS Roma;2075;4;2079
22/02/2019;AC Milan;2046;4;2050;3 - 0;3;0;1;75;16;9;Empoli FC;1776;-4;1772
18/02/2019;AS Roma;2073;2;2075;2 - 1;2;1;1;78;15;7;Bologna FC;1762;-2;1760
17/02/2019;SSC Napoli;2154;-7;2147;0 - 0;0;0;X;68;19;13;Torino FC;1959;7;1966
17/02/2019;Inter;2049;4;2053;2 - 1;2;1;1;65;21;15;Sampdoria;1890;-4;1886
17/02/2019;Genoa CFC;1813;12;1825;2 - 1;2;1;1;29;29;43;Lazio Roma;1982;-12;1970
17/02/2019;SPAL 2013 Ferrara;1776;-12;1764;1 - 4;1;4;2;24;27;49;ACF Fiorentina;1997;12;2009
17/02/2019;Empoli FC;1758;18;1776;3 - 0;3;0;1;34;29;37;Sassuolo Calcio;1872;-18;1854
17/02/2019;Udinese Calcio;1776;6;1782;1 - 0;1;0;1;51;26;23;Chievo Verona;1735;-6;1729
16/02/2019;Atalanta;2059;-20;2039;1 - 3;1;3;2;50;27;23;AC Milan;2026;20;2046
16/02/2019;Cagliari Calcio;1781;7;1788;2 - 1;2;1;1;48;27;25;Parma Calcio 1913;1766;-7;1759
15/02/2019;Juventus;2278;1;2279;3 - 0;3;0;1;88;10;2;Frosinone Calcio;1739;-1;1738
10/02/2019;Sassuolo Calcio;1877;-5;1872;0 - 3;0;3;2;13;19;69;Juventus;2273;5;2278
10/02/2019;Atalanta;2057;2;2059;2 - 1;2;1;1;76;16;9;SPAL 2013 Ferrara;1778;-2;1776
10/02/2019;AC Milan;2022;4;2026;3 - 0;3;0;1;72;17;10;Cagliari Calcio;1785;-4;1781
10/02/2019;Torino FC;1956;3;1959;1 - 0;1;0;1;67;20;14;Udinese Calcio;1779;-3;1776
10/02/2019;Sampdoria;1907;-17;1890;0 - 1;0;1;2;67;20;13;Frosinone Calcio;1722;17;1739
10/02/2019;Bologna FC;1763;-1;1762;1 - 1;1;1;X;41;29;30;Genoa CFC;1812;1;1813
09/02/2019;ACF Fiorentina;1996;1;1997;0 - 0;0;0;X;30;29;41;SSC Napoli;2148;-1;2147
09/02/2019;Parma Calcio 1913;1772;-6;1766;0 - 1;0;1;2;21;25;54;Inter;2038;6;2044
08/02/2019;Chievo Verona;1743;-8;1735;0 - 3;0;3;2;18;23;59;AS Roma;2052;8;2060
07/02/2019;Lazio Roma;1993;3;1996;1 - 0;1;0;1;72;17;11;Empoli FC;1761;-3;1758
04/02/2019;Cagliari Calcio;1791;-6;1785;0 - 1;0;1;2;21;25;53;Atalanta;2051;6;2057
04/02/2019;Frosinone Calcio;1728;-6;1722;0 - 1;0;1;2;21;25;53;Lazio Roma;1987;6;1993
03/02/2019;AS Roma;2056;-4;2052;1 - 1;1;1;X;51;26;23;AC Milan;2018;4;2022
03/02/2019;Inter;2056;-18;2038;0 - 1;0;1;2;78;15;7;Bologna FC;1745;18;1763
03/02/2019;Udinese Calcio;1776;3;1779;1 - 1;1;1;X;24;27;49;ACF Fiorentina;1999;-3;1996
03/02/2019;SPAL 2013 Ferrara;1776;2;1778;0 - 0;0;0;X;28;28;44;Torino FC;1958;-2;1956
03/02/2019;Genoa CFC;1813;-1;1812;1 - 1;1;1;X;39;29;32;Sassuolo Calcio;1876;1;1877
02/02/2019;SSC Napoli;2144;4;2148;3 - 0;3;0;1;72;17;11;Sampdoria;1911;-4;1907
02/02/2019;Juventus;2282;-9;2273;3 - 3;3;3;X;88;10;2;Parma Calcio 1913;1763;9;1772
02/02/2019;Empoli FC;1764;-3;1761;2 - 2;2;2;X;49;27;24;Chievo Verona;1740;3;1743
28/01/2019;Empoli FC;1783;-19;1764;1 - 3;1;3;2;45;28;27;Genoa CFC;1794;19;1813
27/01/2019;Lazio Roma;1986;-4;1982;1 - 2;1;2;2;17;22;60;Juventus;2304;4;2308
27/01/2019;Atalanta;2026;-1;2025;3 - 3;3;3;X;41;29;30;AS Roma;2076;1;2077
27/01/2019;Torino FC;1947;11;1958;1 - 0;1;0;1;33;29;38;Inter;2072;-11;2061
27/01/2019;Chievo Verona;1747;-7;1740;3 - 4;3;4;2;24;27;49;ACF Fiorentina;1971;7;1978
27/01/2019;Parma Calcio 1913;1776;-13;1763;2 - 3;2;3;2;48;27;25;SPAL 2013 Ferrara;1763;13;1776
27/01/2019;Bologna FC;1772;-27;1745;0 - 4;0;4;2;55;25;20;Frosinone Calcio;1701;27;1728
26/01/2019;AC Milan;1998;2;2000;0 - 0;0;0;X;29;29;42;SSC Napoli;2164;-2;2162
26/01/2019;Sampdoria;1903;8;1911;4 - 0;4;0;1;60;23;17;Udinese Calcio;1784;-8;1776
26/01/2019;Sassuolo Calcio;1866;10;1876;3 - 0;3;0;1;54;25;21;Cagliari Calcio;1801;-10;1791
21/01/2019;Juventus;2303;1;2304;3 - 0;3;0;1;88;10;2;Chievo Verona;1748;-1;1747
21/01/2019;Genoa CFC;1806;-12;1794;0 - 2;0;2;2;28;28;44;AC Milan;1986;12;1998
20/01/2019;SSC Napoli;2161;3;2164;2 - 1;2;1;1;66;20;14;Lazio Roma;1989;-3;1986
20/01/2019;ACF Fiorentina;1976;-5;1971;3 - 3;3;3;X;55;25;20;Sampdoria;1898;5;1903
20/01/2019;Frosinone Calcio;1710;-9;1701;0 - 5;0;5;2;18;23;59;Atalanta;2017;9;2026
20/01/2019;Cagliari Calcio;1804;-3;1801;2 - 2;2;2;X;49;27;24;Empoli FC;1780;3;1783
20/01/2019;SPAL 2013 Ferrara;1766;-3;1763;1 - 1;1;1;X;46;28;26;Bologna FC;1769;3;1772
19/01/2019;AS Roma;2072;4;2076;3 - 2;3;2;1;60;23;17;Torino FC;1951;-4;1947
19/01/2019;Inter;2079;-7;2072;0 - 0;0;0;X;71;18;11;Sassuolo Calcio;1859;7;1866
19/01/2019;Udinese Calcio;1798;-14;1784;1 - 2;1;2;2;50;26;23;Parma Calcio 1913;1762;14;1776
29/12/2018;Juventus;2297;1;2298;2 - 1;2;1;1;82;13;5;Sampdoria;1916;-1;1915
29/12/2018;Lazio Roma;1990;-3;1987;1 - 1;1;1;X;49;27;24;Torino FC;1968;3;1971
29/12/2018;SSC Napoli;2157;1;2158;3 - 2;3;2;1;83;12;5;Bologna FC;1772;-1;1771
29/12/2018;Sassuolo Calcio;1880;-18;1862;2 - 6;2;6;2;34;29;36;Atalanta;1988;18;2006
29/12/2018;Empoli FC;1785;-5;1780;0 - 1;0;1;2;19;24;57;Inter;2072;5;2077
29/12/2018;Parma Calcio 1913;1769;-7;1762;0 - 2;0;2;2;19;24;58;AS Roma;2064;7;2071
29/12/2018;Genoa CFC;1805;1;1806;0 - 0;0;0;X;30;29;41;ACF Fiorentina;1957;-1;1956
29/12/2018;AC Milan;1969;3;1972;2 - 1;2;1;1;69;19;12;SPAL 2013 Ferrara;1769;-3;1766
29/12/2018;Udinese Calcio;1785;13;1798;2 - 0;2;0;1;41;29;30;Cagliari Calcio;1828;-13;1815
29/12/2018;Chievo Verona;1741;7;1748;1 - 0;1;0;1;49;27;24;Frosinone Calcio;1717;-7;1710
26/12/2018;Atalanta;1982;6;1988;2 - 2;2;2;X;17;22;61;Juventus;2303;-6;2297
26/12/2018;Inter;2062;10;2072;1 - 0;1;0;1;35;29;36;SSC Napoli;2167;-10;2157
26/12/2018;AS Roma;2059;5;2064;3 - 1;3;1;1;66;20;14;Sassuolo Calcio;1885;-5;1880
26/12/2018;Bologna FC;1783;-11;1772;0 - 2;0;2;2;26;28;46;Lazio Roma;1979;11;1990
26/12/2018;Torino FC;1962;6;1968;3 - 0;3;0;1;66;20;14;Empoli FC;1791;-6;1785
26/12/2018;ACF Fiorentina;1974;-17;1957;0 - 1;0;1;2;71;18;11;Parma Calcio 1913;1752;17;1769
26/12/2018;Frosinone Calcio;1713;4;1717;0 - 0;0;0;X;21;25;53;AC Milan;1973;-4;1969
26/12/2018;Sampdoria;1911;5;1916;2 - 0;2;0;1;65;20;14;Chievo Verona;1746;-5;1741
26/12/2018;Cagliari Calcio;1821;7;1828;1 - 0;1;0;1;47;27;25;Genoa CFC;1812;-7;1805
26/12/2018;SPAL 2013 Ferrara;1771;-2;1769;0 - 0;0;0;X;45;28;27;Udinese Calcio;1783;2;1785
22/12/2018;Juventus;2300;3;2303;1 - 0;1;0;1;72;17;10;AS Roma;2062;-3;2059
22/12/2018;AC Milan;1986;-13;1973;0 - 1;0;1;2;49;27;24;ACF Fiorentina;1961;13;1974
22/12/2018;SSC Napoli;2166;1;2167;1 - 0;1;0;1;83;12;5;SPAL 2013 Ferrara;1772;-1;1771
22/12/2018;Sassuolo Calcio;1886;-1;1885;1 - 1;1;1;X;38;29;33;Torino FC;1961;1;1962
22/12/2018;Chievo Verona;1740;6;1746;1 - 1;1;1;X;17;22;61;Inter;2068;-6;2062
22/12/2018;Lazio Roma;1973;6;1979;3 - 1;3;1;1;63;21;15;Cagliari Calcio;1827;-6;1821
22/12/2018;Genoa CFC;1792;20;1812;3 - 1;3;1;1;25;27;48;Atalanta;2002;-20;1982
22/12/2018;Empoli FC;1807;-16;1791;2 - 4;2;4;2;37;29;34;Sampdoria;1895;16;1911
22/12/2018;Parma Calcio 1913;1754;-2;1752;0 - 0;0;0;X;43;29;28;Bologna FC;1781;2;1783
22/12/2018;Udinese Calcio;1788;-5;1783;1 - 1;1;1;X;56;25;20;Frosinone Calcio;1708;5;1713
18/12/2018;Bologna FC;1778;3;1781;0 - 0;0;0;X;25;27;48;AC Milan;1989;-3;1986
17/12/2018;Atalanta;1995;7;2002;1 - 0;1;0;1;48;27;25;Lazio Roma;1980;-7;1973
16/12/2018;Cagliari Calcio;1831;-4;1827;0 - 1;0;1;2;16;22;62;SSC Napoli;2162;4;2166
16/12/2018;AS Roma;2060;2;2062;3 - 2;3;2;1;75;16;9;Genoa CFC;1794;-2;1792
16/12/2018;ACF Fiorentina;1955;6;1961;3 - 1;3;1;1;63;22;16;Empoli FC;1813;-6;1807
16/12/2018;Sampdoria;1889;6;1895;2 - 0;2;0;1;61;22;16;Parma Calcio 1913;1760;-6;1754
16/12/2018;Frosinone Calcio;1721;-13;1708;0 - 2;0;2;2;30;29;41;Sassuolo Calcio;1873;13;1886
16/12/2018;SPAL 2013 Ferrara;1776;-4;1772;0 - 0;0;0;X;51;26;23;Chievo Verona;1736;4;1740
15/12/2018;Torino FC;1965;-4;1961;0 - 1;0;1;2;16;22;62;Juventus;2296;4;2300
15/12/2018;Inter;2066;2;2068;1 - 0;1;0;1;76;16;9;Udinese Calcio;1790;-2;1788
09/12/2018;AC Milan;2014;-4;2010;0 - 0;0;0;X;52;26;22;Torino FC;1961;4;1965
09/12/2018;Sassuolo Calcio;1874;-1;1873;3 - 3;3;3;X;37;29;33;ACF Fiorentina;1954;1;1955
09/12/2018;Udinese Calcio;1802;-12;1790;1 - 3;1;3;2;28;28;44;Atalanta;1983;12;1995
09/12/2018;Empoli FC;1806;7;1813;2 - 1;2;1;1;49;27;24;Bologna FC;1785;-7;1778
09/12/2018;Genoa CFC;1797;-3;1794;1 - 1;1;1;X;49;27;24;SPAL 2013 Ferrara;1773;3;1776
09/12/2018;Parma Calcio 1913;1764;-4;1760;1 - 1;1;1;X;50;27;23;Chievo Verona;1732;4;1736
08/12/2018;Cagliari Calcio;1827;4;1831;2 - 2;2;2;X;22;25;53;AS Roma;2083;-4;2079
08/12/2018;SSC Napoli;2170;2;2172;4 - 0;4;0;1;85;11;4;Frosinone Calcio;1723;-2;1721
08/12/2018;Lazio Roma;2002;-6;1996;2 - 2;2;2;X;60;23;17;Sampdoria;1883;6;1889
07/12/2018;Juventus;2318;2;2320;1 - 0;1;0;1;73;17;10;Inter;2076;-2;2074
03/12/2018;Atalanta;1991;-8;1983;1 - 2;1;2;2;29;28;43;SSC Napoli;2162;8;2170
02/12/2018;AS Roma;2086;-3;2083;2 - 2;2;2;X;48;27;25;Inter;2073;3;2076
02/12/2018;AC Milan;2012;2;2014;2 - 1;2;1;1;73;17;10;Parma Calcio 1913;1766;-2;1764
02/12/2018;Torino FC;1957;4;1961;2 - 1;2;1;1;64;21;15;Genoa CFC;1808;-4;1804
02/12/2018;Chievo Verona;1738;5;1743;1 - 1;1;1;X;21;25;55;Lazio Roma;2007;-5;2002
02/12/2018;Sassuolo Calcio;1876;-5;1871;0 - 0;0;0;X;56;25;20;Udinese Calcio;1797;5;1802
02/12/2018;Frosinone Calcio;1723;0;1723;1 - 1;1;1;X;36;29;35;Cagliari Calcio;1816;0;1816
01/12/2018;ACF Fiorentina;1961;-7;1954;0 - 3;0;3;2;15;21;64;Juventus;2311;7;2318
01/12/2018;Sampdoria;1869;9;1878;4 - 1;4;1;1;56;24;19;Bologna FC;1785;-9;1776
01/12/2018;SPAL 2013 Ferrara;1780;-2;1778;2 - 2;2;2;X;43;28;28;Empoli FC;1804;2;1806
26/11/2018;Cagliari Calcio;1815;1;1816;0 - 0;0;0;X;31;29;40;Torino FC;1958;-1;1957
25/11/2018;Lazio Roma;2037;-4;2033;1 - 1;1;1;X;50;27;24;AC Milan;2007;4;2011
25/11/2018;SSC Napoli;2165;-9;2156;0 - 0;0;0;X;85;11;4;Chievo Verona;1729;9;1738
25/11/2018;Empoli FC;1791;13;1804;3 - 2;3;2;1;25;27;48;Atalanta;2004;-13;1991
25/11/2018;Bologna FC;1783;2;1785;0 - 0;0;0;X;28;28;44;ACF Fiorentina;1963;-2;1961
25/11/2018;Genoa CFC;1809;-1;1808;1 - 1;1;1;X;40;29;31;Sampdoria;1868;1;1869
25/11/2018;Parma Calcio 1913;1755;11;1766;2 - 1;2;1;1;32;29;39;Sassuolo Calcio;1887;-11;1876
24/11/2018;Juventus;2307;1;2308;2 - 0;2;0;1;88;10;2;SPAL 2013 Ferrara;1781;-1;1780
24/11/2018;Udinese Calcio;1781;16;1797;1 - 0;1;0;1;15;21;63;AS Roma;2126;-16;2110
24/11/2018;Inter;2079;2;2081;3 - 0;3;0;1;81;13;6;Frosinone Calcio;1725;-2;1723
11/11/2018;AC Milan;2015;-8;2007;0 - 2;0;2;2;20;24;56;Juventus;2299;8;2307
11/11/2018;Atalanta;1986;18;2004;4 - 1;4;1;1;34;29;36;Inter;2097;-18;2079
11/11/2018;AS Roma;2122;4;2126;4 - 1;4;1;1;73;17;10;Sampdoria;1872;-4;1868
11/11/2018;Sassuolo Calcio;1886;1;1887;1 - 1;1;1;X;30;29;41;Lazio Roma;2038;-1;2037
11/11/2018;Empoli FC;1784;7;1791;2 - 1;2;1;1;46;28;26;Udinese Calcio;1788;-7;1781
11/11/2018;Chievo Verona;1730;-1;1729;2 - 2;2;2;X;40;29;31;Bologna FC;1782;1;1783
10/11/2018;Genoa CFC;1813;-4;1809;1 - 2;1;2;2;15;21;64;SSC Napoli;2161;4;2165
10/11/2018;Torino FC;1976;-18;1958;1 - 2;1;2;2;73;17;10;Parma Calcio 1913;1737;18;1755
10/11/2018;SPAL 2013 Ferrara;1783;-2;1781;2 - 2;2;2;X;43;29;29;Cagliari Calcio;1813;2;1815
09/11/2018;Frosinone Calcio;1721;4;1725;1 - 1;1;1;X;22;26;52;ACF Fiorentina;1967;-4;1963
04/11/2018;Sampdoria;1891;-19;1872;1 - 4;1;4;2;39;29;32;Torino FC;1957;19;1976
04/11/2018;Lazio Roma;2028;4;2032;4 - 1;4;1;1;73;17;10;SPAL 2013 Ferrara;1787;-4;1783
04/11/2018;Udinese Calcio;1795;-7;1788;0 - 1;0;1;2;25;27;48;AC Milan;2007;7;2014
04/11/2018;Bologna FC;1789;-7;1782;1 - 2;1;2;2;27;28;45;Atalanta;1979;7;1986
04/11/2018;Chievo Verona;1744;-14;1730;0 - 2;0;2;2;33;29;38;Sassuolo Calcio;1872;14;1886
04/11/2018;Parma Calcio 1913;1740;-3;1737;0 - 0;0;0;X;49;27;24;Frosinone Calcio;1718;3;1721
03/11/2018;Juventus;2324;1;2325;3 - 1;3;1;1;87;10;3;Cagliari Calcio;1814;-1;1813
03/11/2018;ACF Fiorentina;1966;1;1967;1 - 1;1;1;X;31;29;40;AS Roma;2110;-1;2109
03/11/2018;Inter;2088;4;2092;5 - 0;5;0;1;75;16;9;Genoa CFC;1817;-4;1813
02/11/2018;SSC Napoli;2159;2;2161;5 - 1;5;1;1;82;13;5;Empoli FC;1786;-2;1784
31/10/2018;AC Milan;2004;3;2007;2 - 1;2;1;1;67;20;13;Genoa CFC;1820;-3;1817
29/10/2018;Lazio Roma;2050;-22;2028;0 - 3;0;3;2;44;28;27;Inter;2066;22;2088
28/10/2018;SSC Napoli;2163;-4;2159;1 - 1;1;1;X;53;26;21;AS Roma;2106;4;2110
28/10/2018;AC Milan;1999;5;2004;3 - 2;3;2;1;58;23;18;Sampdoria;1896;-5;1891
28/10/2018;Sassuolo Calcio;1877;-5;1872;2 - 2;2;2;X;57;24;19;Bologna FC;1784;5;1789
28/10/2018;Genoa CFC;1824;-4;1820;2 - 2;2;2;X;50;27;23;Udinese Calcio;1791;4;1795
28/10/2018;Cagliari Calcio;1808;6;1814;2 - 1;2;1;1;53;26;21;Chievo Verona;1750;-6;1744
28/10/2018;SPAL 2013 Ferrara;1814;-27;1787;0 - 3;0;3;2;61;23;17;Frosinone Calcio;1691;27;1718
27/10/2018;Empoli FC;1788;-2;1786;1 - 2;1;2;2;7;13;80;Juventus;2322;2;2324
27/10/2018;Torino FC;1960;-3;1957;1 - 1;1;1;X;46;28;26;ACF Fiorentina;1963;3;1966
27/10/2018;Atalanta;1974;5;1979;3 - 0;3;0;1;72;18;11;Parma Calcio 1913;1745;-5;1740
22/10/2018;Sampdoria;1900;-4;1896;0 - 0;0;0;X;49;27;24;Sassuolo Calcio;1873;4;1877
21/10/2018;Inter;2066;6;2072;1 - 0;1;0;1;51;26;23;AC Milan;2024;-6;2018
21/10/2018;Parma Calcio 1913;1753;-8;1745;0 - 2;0;2;2;21;25;54;Lazio Roma;2021;8;2029
21/10/2018;ACF Fiorentina;1969;-6;1963;1 - 1;1;1;X;66;20;14;Cagliari Calcio;1802;6;1808
21/10/2018;Bologna FC;1782;2;1784;2 - 2;2;2;X;28;28;44;Torino FC;1962;-2;1960
21/10/2018;Chievo Verona;1764;-14;1750;1 - 5;1;5;2;26;28;46;Atalanta;1960;14;1974
21/10/2018;Frosinone Calcio;1691;0;1691;3 - 3;3;3;X;36;29;35;Empoli FC;1788;0;1788
20/10/2018;Juventus;2320;-9;2311;1 - 1;1;1;X;87;10;3;Genoa CFC;1815;9;1824
20/10/2018;Udinese Calcio;1798;-7;1791;0 - 3;0;3;2;15;21;64;SSC Napoli;2148;7;2155
20/10/2018;AS Roma;2122;-28;2094;0 - 2;0;2;2;80;14;6;SPAL 2013 Ferrara;1786;28;1814
07/10/2018;SSC Napoli;2145;3;2148;2 - 0;2;0;1;75;16;9;Sassuolo Calcio;1876;-3;1873
07/10/2018;Lazio Roma;2015;6;2021;1 - 0;1;0;1;51;26;23;ACF Fiorentina;1975;-6;1969
07/10/2018;Atalanta;1975;-15;1960;0 - 1;0;1;2;57;24;19;Sampdoria;1885;15;1900
07/10/2018;SPAL 2013 Ferrara;1791;-5;1786;1 - 2;1;2;2;21;25;55;Inter;2061;5;2066
07/10/2018;AC Milan;2021;3;2024;3 - 1;3;1;1;74;17;10;Chievo Verona;1767;-3;1764
07/10/2018;Genoa CFC;1838;-23;1815;1 - 3;1;3;2;59;23;18;Parma Calcio 1913;1730;23;1753
06/10/2018;Udinese Calcio;1800;-2;1798;0 - 2;0;2;2;7;14;79;Juventus;2318;2;2320
06/10/2018;Empoli FC;1795;-7;1788;0 - 2;0;2;2;17;22;61;AS Roma;2115;7;2122
06/10/2018;Cagliari Calcio;1791;11;1802;2 - 0;2;0;1;46;28;26;Bologna FC;1793;-11;1782
05/10/2018;Torino FC;1960;2;1962;3 - 2;3;2;1;75;16;9;Frosinone Calcio;1693;-2;1691
01/10/2018;Sampdoria;1880;5;1885;2 - 1;2;1;1;56;24;19;SPAL 2013 Ferrara;1796;-5;1791
30/09/2018;ACF Fiorentina;1963;12;1975;2 - 0;2;0;1;43;28;28;Atalanta;1987;-12;1975
30/09/2018;Sassuolo Calcio;1893;-17;1876;1 - 4;1;4;2;35;29;36;AC Milan;1997;17;2014
30/09/2018;Chievo Verona;1775;-8;1767;0 - 1;0;1;2;28;28;44;Torino FC;1952;8;1960
30/09/2018;Bologna FC;1785;8;1793;2 - 1;2;1;1;44;28;28;Udinese Calcio;1808;-8;1800
30/09/2018;Frosinone Calcio;1702;-9;1693;1 - 2;1;2;2;33;29;38;Genoa CFC;1829;9;1838
30/09/2018;Parma Calcio 1913;1720;10;1730;1 - 0;1;0;1;37;29;34;Empoli FC;1805;-10;1795
29/09/2018;Juventus;2309;5;2314;3 - 1;3;1;1;66;20;14;SSC Napoli;2136;-5;2131
29/09/2018;AS Roma;2099;9;2108;3 - 1;3;1;1;52;26;22;Lazio Roma;2047;-9;2038
29/09/2018;Inter;2039;4;2043;2 - 0;2;0;1;73;17;10;Cagliari Calcio;1795;-4;1791
27/09/2018;Empoli FC;1802;3;1805;1 - 1;1;1;X;26;28;46;AC Milan;2000;-3;1997
27/09/2018;SPAL 2013 Ferrara;1813;-17;1796;0 - 2;0;2;2;39;29;32;Sassuolo Calcio;1876;17;1893
26/09/2018;Juventus;2308;1;2309;2 - 0;2;0;1;88;10;2;Bologna FC;1786;-1;1785
26/09/2018;Atalanta;1991;-4;1987;0 - 0;0;0;X;51;26;23;Torino FC;1948;4;1952
26/09/2018;SSC Napoli;2134;2;2136;3 - 0;3;0;1;84;12;4;Parma Calcio 1913;1722;-2;1720
26/09/2018;Udinese Calcio;1814;-6;1808;1 - 2;1;2;2;24;27;50;Lazio Roma;2041;6;2047
26/09/2018;AS Roma;2097;2;2099;4 - 0;4;0;1;83;12;5;Frosinone Calcio;1704;-2;1702
26/09/2018;Cagliari Calcio;1795;0;1795;0 - 0;0;0;X;37;29;34;Sampdoria;1880;0;1880
26/09/2018;Genoa CFC;1820;9;1829;2 - 0;2;0;1;50;26;23;Chievo Verona;1784;-9;1775
25/09/2018;Inter;2033;6;2039;2 - 1;2;1;1;54;25;21;ACF Fiorentina;1969;-6;1963
23/09/2018;Torino FC;1960;-12;1948;1 - 3;1;3;2;29;29;42;SSC Napoli;2122;12;2134
23/09/2018;Frosinone Calcio;1706;-2;1704;0 - 2;0;2;2;5;12;84;Juventus;2306;2;2308
23/09/2018;AC Milan;2003;-3;2000;2 - 2;2;2;X;48;27;25;Atalanta;1988;3;1991
23/09/2018;Bologna FC;1762;24;1786;2 - 0;2;0;1;15;20;65;AS Roma;2121;-24;2097
23/09/2018;Lazio Roma;2036;5;2041;4 - 1;4;1;1;70;18;12;Genoa CFC;1825;-5;1820
23/09/2018;Chievo Verona;1804;-20;1784;0 - 2;0;2;2;47;27;25;Udinese Calcio;1794;20;1814
22/09/2018;Sampdoria;1889;-9;1880;0 - 1;0;1;2;32;29;39;Inter;2024;9;2033
22/09/2018;ACF Fiorentina;1962;7;1969;3 - 0;3;0;1;63;22;16;SPAL 2013 Ferrara;1820;-7;1813
22/09/2018;Parma Calcio 1913;1707;15;1722;2 - 0;2;0;1;35;29;36;Cagliari Calcio;1810;-15;1795
21/09/2018;Sassuolo Calcio;1867;9;1876;3 - 1;3;1;1;53;26;22;Empoli FC;1811;-9;1802
19/09/2018;Sampdoria;1890;-1;1889;1 - 1;1;1;X;38;29;32;ACF Fiorentina;1961;1;1962
17/09/2018;SPAL 2013 Ferrara;1801;19;1820;2 - 0;2;0;1;26;27;47;Atalanta;2007;-19;1988
16/09/2018;Juventus;2294;1;2295;2 - 1;2;1;1;84;12;4;Sassuolo Calcio;1868;-1;1867
16/09/2018;AS Roma;2140;-9;2131;2 - 2;2;2;X;80;13;6;Chievo Verona;1795;9;1804
16/09/2018;Empoli FC;1818;-7;1811;0 - 1;0;1;2;25;27;47;Lazio Roma;2026;7;2033
16/09/2018;Cagliari Calcio;1807;3;1810;1 - 1;1;1;X;26;28;46;AC Milan;2003;-3;2000
16/09/2018;Udinese Calcio;1792;2;1794;1 - 1;1;1;X;29;29;43;Torino FC;1962;-2;1960
16/09/2018;Genoa CFC;1819;6;1825;1 - 0;1;0;1;52;26;22;Bologna FC;1768;-6;1762
15/09/2018;SSC Napoli;2124;4;2128;1 - 0;1;0;1;65;21;15;ACF Fiorentina;1965;-4;1961
15/09/2018;Inter;2025;-19;2006;0 - 1;0;1;2;80;14;6;Parma Calcio 1913;1688;19;1707
15/09/2018;Frosinone Calcio;1723;-17;1706;0 - 5;0;5;2;30;29;41;Sampdoria;1873;17;1890
02/09/2018;Sampdoria;1846;27;1873;3 - 0;3;0;1;18;23;59;SSC Napoli;2151;-27;2124
02/09/2018;Atalanta;2024;-17;2007;0 - 1;0;1;2;72;17;11;Cagliari Calcio;1790;17;1807
02/09/2018;Torino FC;1958;4;1962;1 - 0;1;0;1;64;21;15;SPAL 2013 Ferrara;1805;-4;1801
02/09/2018;ACF Fiorentina;1961;4;1965;1 - 0;1;0;1;65;20;14;Udinese Calcio;1796;-4;1792
02/09/2018;Lazio Roma;2024;2;2026;1 - 0;1;0;1;77;15;8;Frosinone Calcio;1725;-2;1723
02/09/2018;Sassuolo Calcio;1858;10;1868;5 - 3;5;3;1;50;27;24;Genoa CFC;1829;-10;1819
02/09/2018;Chievo Verona;1797;-2;1795;0 - 0;0;0;X;44;28;28;Empoli FC;1816;2;1818
01/09/2018;Parma Calcio 1913;1689;-1;1688;1 - 2;1;2;2;5;11;84;Juventus;2293;1;2294
01/09/2018;Bologna FC;1779;-11;1768;0 - 3;0;3;2;23;26;50;Inter;2014;11;2025
31/08/2018;AC Milan;1991;12;2003;2 - 1;2;1;1;29;29;42;AS Roma;2152;-12;2140
27/08/2018;AS Roma;2158;-6;2152;3 - 3;3;3;X;62;22;16;Atalanta;2021;6;2027
26/08/2018;Inter;2018;-4;2014;2 - 2;2;2;X;54;25;21;Torino FC;1954;4;1958
26/08/2018;ACF Fiorentina;1953;8;1961;6 - 1;6;1;1;63;21;15;Chievo Verona;1805;-8;1797
26/08/2018;Cagliari Calcio;1791;-1;1790;2 - 2;2;2;X;39;29;32;Sassuolo Calcio;1857;1;1858
26/08/2018;Genoa CFC;1822;7;1829;2 - 1;2;1;1;46;28;26;Empoli FC;1823;-7;1816
26/08/2018;Udinese Calcio;1787;9;1796;1 - 0;1;0;1;39;29;32;Sampdoria;1855;-9;1846
26/08/2018;Frosinone Calcio;1726;-1;1725;0 - 0;0;0;X;40;29;31;Bologna FC;1778;1;1779
26/08/2018;SPAL 2013 Ferrara;1800;5;1805;1 - 0;1;0;1;59;23;18;Parma Calcio 1913;1694;-5;1689
25/08/2018;Juventus;2290;3;2293;2 - 0;2;0;1;75;16;9;Lazio Roma;2027;-3;2024
25/08/2018;SSC Napoli;2147;4;2151;3 - 2;3;2;1;64;21;15;AC Milan;1995;-4;1991
20/08/2018;Atalanta;2025;3;2028;4 - 0;4;0;1;77;15;8;Frosinone Calcio;1729;-3;1726
19/08/2018;Torino FC;1961;-7;1954;0 - 1;0;1;2;27;28;45;AS Roma;2151;7;2158
19/08/2018;Sassuolo Calcio;1845;12;1857;1 - 0;1;0;1;27;28;45;Inter;2030;-12;2018
19/08/2018;Empoli FC;1813;10;1823;2 - 0;2;0;1;48;27;25;Cagliari Calcio;1801;-10;1791
19/08/2018;Bologna FC;1791;-13;1778;0 - 1;0;1;2;47;28;26;SPAL 2013 Ferrara;1787;13;1800
19/08/2018;Parma Calcio 1913;1694;0;1694;2 - 2;2;2;X;36;29;35;Udinese Calcio;1787;0;1787
18/08/2018;Lazio Roma;2037;-10;2027;1 - 2;1;2;2;35;29;35;SSC Napoli;2137;10;2147
18/08/2018;Chievo Verona;1807;-2;1805;2 - 3;2;3;2;9;15;76;Juventus;2288;2;2290
20/05/2018;Lazio Roma;2051;-14;2037;2 - 3;2;3;2;50;27;23;Inter;2016;14;2030
20/05/2018;Sassuolo Calcio;1846;-5;1841;0 - 1;0;1;2;18;23;58;AS Roma;2146;5;2151
20/05/2018;AC Milan;1982;13;1995;5 - 1;5;1;1;48;27;25;ACF Fiorentina;1966;-13;1953
20/05/2018;SSC Napoli;2136;1;2137;2 - 1;2;1;1;81;13;6;FC Crotone;1787;-1;1786
20/05/2018;Cagliari Calcio;1781;14;1795;1 - 0;1;0;1;22;25;53;Atalanta;2035;-14;2021
20/05/2018;Genoa CFC;1820;-9;1811;1 - 2;1;2;2;32;29;38;Torino FC;1949;9;1958
20/05/2018;SPAL 2013 Ferrara;1763;15;1778;3 - 1;3;1;1;35;29;36;Sampdoria;1870;-15;1855
20/05/2018;Udinese Calcio;1796;7;1803;1 - 0;1;0;1;47;28;26;Bologna FC;1793;-7;1786
20/05/2018;Chievo Verona;1800;4;1804;1 - 0;1;0;1;63;21;15;Benevento Calcio;1655;-4;1651
19/05/2018;Juventus;2288;0;2288;2 - 1;2;1;1;89;9;2;Hellas Verona;1679;0;1679
13/05/2018;AS Roma;2145;1;2146;0 - 0;0;0;X;31;29;40;Juventus;2289;-1;2288
13/05/2018;Atalanta;2039;-4;2035;1 - 1;1;1;X;53;25;21;AC Milan;1978;4;1982
13/05/2018;Sampdoria;1879;-9;1870;0 - 2;0;2;2;22;26;52;SSC Napoli;2127;9;2136
13/05/2018;FC Crotone;1782;5;1787;2 - 2;2;2;X;20;25;55;Lazio Roma;2056;-5;2051
13/05/2018;ACF Fiorentina;1983;-17;1966;0 - 1;0;1;2;71;18;11;Cagliari Calcio;1764;17;1781
13/05/2018;Torino FC;1946;3;1949;2 - 1;2;1;1;67;20;13;SPAL 2013 Ferrara;1766;-3;1763
13/05/2018;Bologna FC;1806;-13;1793;1 - 2;1;2;2;48;27;24;Chievo Verona;1787;13;1800
13/05/2018;Hellas Verona;1689;-10;1679;0 - 1;0;1;2;36;29;35;Udinese Calcio;1786;10;1796
12/05/2018;Inter;2033;-17;2016;1 - 2;1;2;2;69;19;12;Sassuolo Calcio;1829;17;1846
12/05/2018;Benevento Calcio;1642;13;1655;1 - 0;1;0;1;27;28;45;Genoa CFC;1833;-13;1820
06/05/2018;Lazio Roma;2059;-3;2056;1 - 1;1;1;X;49;27;24;Atalanta;2036;3;2039
06/05/2018;SSC Napoli;2134;-7;2127;2 - 2;2;2;X;68;19;13;Torino FC;1939;7;1946
06/05/2018;Cagliari Calcio;1767;-3;1764;0 - 1;0;1;2;14;20;67;AS Roma;2142;3;2145
06/05/2018;Udinese Calcio;1798;-12;1786;0 - 4;0;4;2;24;27;49;Inter;2021;12;2033
06/05/2018;Genoa CFC;1842;-9;1833;2 - 3;2;3;2;32;29;39;ACF Fiorentina;1974;9;1983
06/05/2018;Sassuolo Calcio;1820;9;1829;1 - 0;1;0;1;39;29;32;Sampdoria;1888;-9;1879
06/05/2018;Chievo Verona;1780;7;1787;2 - 1;2;1;1;45;28;27;FC Crotone;1789;-7;1782
06/05/2018;SPAL 2013 Ferrara;1759;7;1766;2 - 0;2;0;1;59;23;18;Benevento Calcio;1649;-7;1642
05/05/2018;Juventus;2282;1;2283;3 - 1;3;1;1;86;11;3;Bologna FC;1807;-1;1806
05/05/2018;AC Milan;1981;3;1984;4 - 1;4;1;1;77;15;8;Hellas Verona;1692;-3;1689
29/04/2018;ACF Fiorentina;1951;23;1974;3 - 0;3;0;1;26;27;47;SSC Napoli;2157;-23;2134
29/04/2018;Torino FC;1949;-10;1939;0 - 1;0;1;2;35;29;35;Lazio Roma;2049;10;2059
29/04/2018;Atalanta;2031;5;2036;3 - 1;3;1;1;67;20;13;Genoa CFC;1847;-5;1842
29/04/2018;Bologna FC;1815;-8;1807;1 - 2;1;2;2;30;29;42;AC Milan;1973;8;1981
29/04/2018;Sampdoria;1880;8;1888;4 - 1;4;1;1;59;23;18;Cagliari Calcio;1775;-8;1767
29/04/2018;FC Crotone;1773;16;1789;4 - 1;4;1;1;39;29;32;Sassuolo Calcio;1836;-16;1820
29/04/2018;Hellas Verona;1710;-18;1692;1 - 3;1;3;2;43;29;29;SPAL 2013 Ferrara;1741;18;1759
29/04/2018;Benevento Calcio;1647;2;1649;3 - 3;3;3;X;30;29;41;Udinese Calcio;1800;-2;1798
28/04/2018;Inter;2027;-6;2021;2 - 3;2;3;2;22;26;52;Juventus;2276;6;2282
28/04/2018;AS Roma;2116;3;2119;4 - 1;4;1;1;80;14;7;Chievo Verona;1783;-3;1780
23/04/2018;Genoa CFC;1841;6;1847;3 - 1;3;1;1;61;22;17;Hellas Verona;1716;-6;1710
22/04/2018;Juventus;2292;-16;2276;0 - 1;0;1;2;64;21;15;SSC Napoli;2141;16;2157
22/04/2018;Atalanta;2026;5;2031;2 - 1;2;1;1;55;25;20;Torino FC;1954;-5;1949
22/04/2018;Lazio Roma;2042;7;2049;4 - 0;4;0;1;64;21;15;Sampdoria;1887;-7;1880
22/04/2018;Chievo Verona;1789;-6;1783;1 - 2;1;2;2;23;26;50;Inter;2021;6;2027
22/04/2018;Cagliari Calcio;1777;-2;1775;0 - 0;0;0;X;42;29;29;Bologna FC;1813;2;1815
22/04/2018;Udinese Calcio;1814;-14;1800;1 - 2;1;2;2;53;26;22;FC Crotone;1759;14;1773
21/04/2018;SPAL 2013 Ferrara;1747;-6;1741;0 - 3;0;3;2;14;20;67;AS Roma;2123;6;2129
21/04/2018;Sassuolo Calcio;1825;11;1836;1 - 0;1;0;1;32;29;39;ACF Fiorentina;1962;-11;1951
21/04/2018;AC Milan;1992;-19;1973;0 - 1;0;1;2;81;13;6;Benevento Calcio;1628;19;1647
18/04/2018;FC Crotone;1750;9;1759;1 - 1;1;1;X;6;13;81;Juventus;2301;-9;2292
18/04/2018;ACF Fiorentina;1973;-11;1962;3 - 4;3;4;2;40;29;31;Lazio Roma;2031;11;2042
18/04/2018;AS Roma;2121;2;2123;2 - 1;2;1;1;76;16;9;Genoa CFC;1843;-2;1841
18/04/2018;SSC Napoli;2139;2;2141;4 - 2;4;2;1;79;14;7;Udinese Calcio;1816;-2;1814
18/04/2018;Torino FC;1956;-2;1954;1 - 1;1;1;X;42;29;29;AC Milan;1990;2;1992
18/04/2018;Sampdoria;1881;6;1887;1 - 0;1;0;1;54;25;21;Bologna FC;1819;-6;1813
18/04/2018;Benevento Calcio;1634;-6;1628;0 - 3;0;3;2;13;19;68;Atalanta;2020;6;2026
18/04/2018;Hellas Verona;1726;-10;1716;0 - 1;0;1;2;36;29;34;Sassuolo Calcio;1815;10;1825
18/04/2018;SPAL 2013 Ferrara;1749;-2;1747;0 - 0;0;0;X;42;29;29;Chievo Verona;1787;2;1789
17/04/2018;Inter;2016;5;2021;4 - 0;4;0;1;72;17;11;Cagliari Calcio;1782;-5;1777
15/04/2018;Juventus;2299;2;2301;3 - 0;3;0;1;84;12;4;Sampdoria;1883;-2;1881
15/04/2018;Lazio Roma;2031;0;2031;0 - 0;0;0;X;36;29;34;AS Roma;2121;0;2121
15/04/2018;AC Milan;1988;2;1990;0 - 0;0;0;X;30;29;41;SSC Napoli;2141;-2;2139
15/04/2018;ACF Fiorentina;1980;-7;1973;0 - 0;0;0;X;72;17;10;SPAL 2013 Ferrara;1742;7;1749
15/04/2018;Bologna FC;1811;8;1819;2 - 0;2;0;1;55;25;20;Hellas Verona;1734;-8;1726
15/04/2018;Sassuolo Calcio;1822;-7;1815;2 - 2;2;2;X;68;19;13;Benevento Calcio;1627;7;1634
14/04/2018;Atalanta;2023;-3;2020;0 - 0;0;0;X;47;27;25;Inter;2013;3;2016
14/04/2018;Chievo Verona;1785;2;1787;0 - 0;0;0;X;28;28;43;Torino FC;1958;-2;1956
14/04/2018;Cagliari Calcio;1773;9;1782;2 - 1;2;1;1;40;29;31;Udinese Calcio;1825;-9;1816
14/04/2018;Genoa CFC;1838;5;1843;1 - 0;1;0;1;56;24;20;FC Crotone;1755;-5;1750
08/04/2018;Torino FC;1949;9;1958;1 - 0;1;0;1;38;29;33;Inter;2022;-9;2013
08/04/2018;SSC Napoli;2140;1;2141;2 - 1;2;1;1;81;13;6;Chievo Verona;1786;-1;1785
08/04/2018;Udinese Calcio;1832;-7;1825;1 - 2;1;2;2;25;27;48;Lazio Roma;2045;7;2052
08/04/2018;AC Milan;1995;-7;1988;1 - 1;1;1;X;67;20;13;Sassuolo Calcio;1815;7;1822
08/04/2018;FC Crotone;1746;9;1755;1 - 0;1;0;1;38;29;33;Bologna FC;1820;-9;1811
08/04/2018;Hellas Verona;1725;9;1734;1 - 0;1;0;1;40;29;31;Cagliari Calcio;1782;-9;1773
07/04/2018;AS Roma;2109;-24;2085;0 - 2;0;2;2;64;21;15;ACF Fiorentina;1956;24;1980
07/04/2018;Benevento Calcio;1628;-1;1627;2 - 4;2;4;2;4;11;85;Juventus;2266;1;2267
07/04/2018;SPAL 2013 Ferrara;1737;5;1742;1 - 1;1;1;X;19;24;57;Atalanta;2028;-5;2023
07/04/2018;Sampdoria;1887;-4;1883;0 - 0;0;0;X;52;26;22;Genoa CFC;1834;4;1838
04/04/2018;AC Milan;1997;-2;1995;0 - 0;0;0;X;44;28;28;Inter;2020;2;2022
04/04/2018;Torino FC;1943;6;1949;4 - 1;4;1;1;68;19;13;FC Crotone;1752;-6;1746
04/04/2018;Chievo Verona;1788;-2;1786;1 - 1;1;1;X;43;28;28;Sassuolo Calcio;1813;2;1815
04/04/2018;Benevento Calcio;1609;19;1628;3 - 0;3;0;1;32;29;39;Hellas Verona;1744;-19;1725
03/04/2018;Atalanta;2045;-17;2028;1 - 2;1;2;2;66;20;14;Sampdoria;1870;17;1887
03/04/2018;Udinese Calcio;1847;-15;1832;0 - 2;0;2;2;36;29;35;ACF Fiorentina;1941;15;1956
03/04/2018;Genoa CFC;1828;6;1834;2 - 1;2;1;1;51;26;23;Cagliari Calcio;1788;-6;1782
31/03/2018;Juventus;2296;3;2299;3 - 1;3;1;1;77;15;8;AC Milan;2000;-3;1997
31/03/2018;Sassuolo Calcio;1807;6;1813;1 - 1;1;1;X;16;21;63;SSC Napoli;2146;-6;2140
31/03/2018;Bologna FC;1815;5;1820;1 - 1;1;1;X;18;23;59;AS Roma;2122;-5;2117
31/03/2018;Atalanta;2040;5;2045;2 - 0;2;0;1;68;19;13;Udinese Calcio;1852;-5;1847
31/03/2018;Inter;2016;4;2020;3 - 0;3;0;1;75;16;9;Hellas Verona;1748;-4;1744
31/03/2018;Cagliari Calcio;1806;-18;1788;0 - 4;0;4;2;33;29;37;Torino FC;1925;18;1943
31/03/2018;ACF Fiorentina;1936;5;1941;2 - 0;2;0;1;67;20;13;FC Crotone;1757;-5;1752
31/03/2018;Chievo Verona;1778;10;1788;2 - 1;2;1;1;35;29;35;Sampdoria;1880;-10;1870
31/03/2018;Lazio Roma;2031;2;2033;6 - 2;6;2;1;84;12;4;Benevento Calcio;1611;-2;1609
31/03/2018;Genoa CFC;1833;-5;1828;1 - 1;1;1;X;58;24;18;SPAL 2013 Ferrara;1732;5;1737
18/03/2018;SSC Napoli;2144;2;2146;1 - 0;1;0;1;78;15;7;Genoa CFC;1835;-2;1833
18/03/2018;Sampdoria;1900;-20;1880;0 - 5;0;5;2;36;29;35;Inter;1996;20;2016
18/03/2018;FC Crotone;1763;-6;1757;0 - 2;0;2;2;15;21;64;AS Roma;2116;6;2122
18/03/2018;Torino FC;1938;-13;1925;1 - 2;1;2;2;48;27;25;ACF Fiorentina;1923;13;1936
18/03/2018;Lazio Roma;2038;-7;2031;1 - 1;1;1;X;72;18;11;Bologna FC;1808;7;1815
18/03/2018;Hellas Verona;1759;-11;1748;0 - 5;0;5;2;21;25;55;Atalanta;2029;11;2040
18/03/2018;AC Milan;1997;3;2000;3 - 2;3;2;1;70;18;11;Chievo Verona;1781;-3;1778
18/03/2018;Benevento Calcio;1619;-8;1611;1 - 2;1;2;2;28;28;44;Cagliari Calcio;1798;8;1806
17/03/2018;SPAL 2013 Ferrara;1723;9;1732;0 - 0;0;0;X;5;12;83;Juventus;2305;-9;2296
17/03/2018;Udinese Calcio;1867;-15;1852;1 - 2;1;2;2;55;25;20;Sassuolo Calcio;1792;15;1807
14/03/2018;Juventus;2302;3;2305;2 - 0;2;0;1;75;16;9;Atalanta;2032;-3;2029
11/03/2018;Juventus;2301;1;2302;2 - 0;2;0;1;85;11;4;Udinese Calcio;1868;-1;1867
11/03/2018;Inter;1995;1;1996;0 - 0;0;0;X;30;29;41;SSC Napoli;2145;-1;2144
11/03/2018;Genoa CFC;1843;-8;1835;0 - 1;0;1;2;30;29;41;AC Milan;2000;8;2008
11/03/2018;Bologna FC;1815;-7;1808;0 - 1;0;1;2;25;27;48;Atalanta;2025;7;2032
11/03/2018;Cagliari Calcio;1794;4;1798;2 - 2;2;2;X;24;27;50;Lazio Roma;2022;-4;2018
11/03/2018;FC Crotone;1741;22;1763;4 - 1;4;1;1;28;28;44;Sampdoria;1922;-22;1900
11/03/2018;ACF Fiorentina;1921;2;1923;1 - 0;1;0;1;77;15;8;Benevento Calcio;1621;-2;1619
11/03/2018;Sassuolo Calcio;1797;-5;1792;1 - 1;1;1;X;56;25;20;SPAL 2013 Ferrara;1718;5;1723
10/03/2018;Hellas Verona;1751;8;1759;1 - 0;1;0;1;42;29;29;Chievo Verona;1789;-8;1781
09/03/2018;AS Roma;2099;7;2106;3 - 0;3;0;1;64;21;15;Torino FC;1945;-7;1938
03/03/2018;Lazio Roma;2035;-6;2029;0 - 1;0;1;2;23;26;52;Juventus;2279;6;2285
03/03/2018;SSC Napoli;2167;-22;2145;2 - 4;2;4;2;57;24;19;AS Roma;2077;22;2099
03/03/2018;SPAL 2013 Ferrara;1708;10;1718;1 - 0;1;0;1;34;29;37;Bologna FC;1825;-10;1815
26/02/2018;Cagliari Calcio;1801;-7;1794;0 - 5;0;5;2;15;20;65;SSC Napoli;2160;7;2167
25/02/2018;AS Roma;2100;-23;2077;0 - 2;0;2;2;58;23;18;AC Milan;1997;23;2020
25/02/2018;Sassuolo Calcio;1809;-12;1797;0 - 3;0;3;2;25;27;48;Lazio Roma;2026;12;2038
25/02/2018;Sampdoria;1916;6;1922;2 - 1;2;1;1;51;26;23;Udinese Calcio;1874;-6;1868
25/02/2018;ACF Fiorentina;1917;4;1921;1 - 0;1;0;1;61;22;17;Chievo Verona;1793;-4;1789
25/02/2018;Hellas Verona;1738;13;1751;2 - 1;2;1;1;24;27;49;Torino FC;1958;-13;1945
25/02/2018;FC Crotone;1755;-14;1741;2 - 3;2;3;2;53;25;21;SPAL 2013 Ferrara;1694;14;1708
24/02/2018;Bologna FC;1812;13;1825;2 - 0;2;0;1;41;29;30;Genoa CFC;1856;-13;1843
24/02/2018;Inter;1993;2;1995;2 - 0;2;0;1;82;13;5;Benevento Calcio;1623;-2;1621
19/02/2018;Lazio Roma;2014;3;2017;2 - 0;2;0;1;75;16;9;Hellas Verona;1741;-3;1738
18/02/2018;Torino FC;1963;-5;1958;0 - 1;0;1;2;18;23;59;Juventus;2272;5;2277
18/02/2018;Atalanta;2036;-6;2030;1 - 1;1;1;X;61;22;17;ACF Fiorentina;1911;6;1917
18/02/2018;AC Milan;1987;6;1993;1 - 0;1;0;1;54;25;21;Sampdoria;1922;-6;1916
18/02/2018;SSC Napoli;2142;1;2143;1 - 0;1;0;1;85;11;4;SPAL 2013 Ferrara;1695;-1;1694
18/02/2018;Bologna FC;1804;8;1812;2 - 1;2;1;1;45;28;27;Sassuolo Calcio;1817;-8;1809
18/02/2018;Benevento Calcio;1611;12;1623;3 - 2;3;2;1;30;29;41;FC Crotone;1767;-12;1755
17/02/2018;Udinese Calcio;1884;-10;1874;0 - 2;0;2;2;25;27;48;AS Roma;2102;10;2112
17/02/2018;Genoa CFC;1838;18;1856;2 - 0;2;0;1;28;28;43;Inter;2011;-18;1993
17/02/2018;Chievo Verona;1785;8;1793;2 - 1;2;1;1;43;28;28;Cagliari Calcio;1809;-8;1801
11/02/2018;Torino FC;1954;9;1963;2 - 0;2;0;1;53;25;21;Udinese Calcio;1893;-9;1884
11/02/2018;Inter;2008;3;2011;2 - 1;2;1;1;69;19;12;Bologna FC;1807;-3;1804
11/02/2018;AS Roma;2101;1;2102;5 - 2;5;2;1;87;10;3;Benevento Calcio;1612;-1;1611
11/02/2018;Sampdoria;1917;5;1922;2 - 0;2;0;1;66;20;14;Hellas Verona;1746;-5;1741
11/02/2018;Sassuolo Calcio;1820;-3;1817;0 - 0;0;0;X;48;27;25;Cagliari Calcio;1806;3;1809
11/02/2018;Chievo Verona;1797;-12;1785;0 - 1;0;1;2;43;29;29;Genoa CFC;1826;12;1838
10/02/2018;SSC Napoli;2167;7;2174;4 - 1;4;1;1;62;22;16;Lazio Roma;2036;-7;2029
10/02/2018;FC Crotone;1762;5;1767;1 - 1;1;1;X;19;24;57;Atalanta;2051;-5;2046
10/02/2018;SPAL 2013 Ferrara;1706;-11;1695;0 - 4;0;4;2;22;26;52;AC Milan;1957;11;1968
09/02/2018;ACF Fiorentina;1917;-6;1911;0 - 2;0;2;2;15;21;65;Juventus;2273;6;2279
05/02/2018;Lazio Roma;2054;-18;2036;1 - 2;1;2;2;73;17;10;Genoa CFC;1808;18;1826
04/02/2018;Juventus;2271;2;2273;7 - 0;7;0;1;85;11;4;Sassuolo Calcio;1822;-2;1820
04/02/2018;Udinese Calcio;1894;-1;1893;1 - 1;1;1;X;39;29;32;AC Milan;1956;1;1957
04/02/2018;Atalanta;2049;2;2051;1 - 0;1;0;1;73;17;10;Chievo Verona;1799;-2;1797
04/02/2018;Hellas Verona;1750;-4;1746;0 - 1;0;1;2;15;21;64;AS Roma;2097;4;2101
04/02/2018;Benevento Calcio;1614;-2;1612;0 - 2;0;2;2;6;13;81;SSC Napoli;2165;2;2167
04/02/2018;Bologna FC;1817;-10;1807;1 - 2;1;2;2;36;29;34;ACF Fiorentina;1907;10;1917
04/02/2018;Cagliari Calcio;1798;8;1806;2 - 0;2;0;1;56;24;19;SPAL 2013 Ferrara;1714;-8;1706
03/02/2018;Sampdoria;1919;-2;1917;1 - 1;1;1;X;42;29;29;Torino FC;1952;2;1954
03/02/2018;Inter;2016;-8;2008;1 - 1;1;1;X;74;16;9;FC Crotone;1754;8;1762
28/01/2018;AS Roma;2114;-17;2097;0 - 1;0;1;2;70;18;12;Sampdoria;1902;17;1919
28/01/2018;AC Milan;1945;11;1956;2 - 1;2;1;1;33;29;37;Lazio Roma;2065;-11;2054
28/01/2018;SSC Napoli;2163;2;2165;3 - 1;3;1;1;80;13;6;Bologna FC;1819;-2;1817
28/01/2018;SPAL 2013 Ferrara;1709;5;1714;1 - 1;1;1;X;18;23;60;Inter;2021;-5;2016
28/01/2018;Genoa CFC;1819;-11;1808;0 - 1;0;1;2;39;29;32;Udinese Calcio;1883;11;1894
28/01/2018;ACF Fiorentina;1937;-30;1907;1 - 4;1;4;2;71;18;11;Hellas Verona;1720;30;1750
28/01/2018;Torino FC;1949;3;1952;3 - 0;3;0;1;80;14;7;Benevento Calcio;1617;-3;1614
28/01/2018;FC Crotone;1756;-2;1754;1 - 1;1;1;X;42;29;30;Cagliari Calcio;1796;2;1798
27/01/2018;Chievo Verona;1802;-3;1799;0 - 2;0;2;2;9;16;75;Juventus;2261;3;2264
27/01/2018;Sassuolo Calcio;1834;-12;1822;0 - 3;0;3;2;25;27;48;Atalanta;2044;12;2056
24/01/2018;Sampdoria;1899;3;1902;1 - 1;1;1;X;25;27;48;AS Roma;2117;-3;2114
24/01/2018;Lazio Roma;2059;6;2065;3 - 0;3;0;1;66;20;14;Udinese Calcio;1889;-6;1883
22/01/2018;Juventus;2260;1;2261;1 - 0;1;0;1;85;11;4;Genoa CFC;1820;-1;1819
21/01/2018;Atalanta;2054;-10;2044;0 - 1;0;1;2;35;29;35;SSC Napoli;2153;10;2163
21/01/2018;Inter;2021;0;2021;1 - 1;1;1;X;36;29;35;AS Roma;2117;0;2117
21/01/2018;Lazio Roma;2055;4;2059;5 - 1;5;1;1;73;17;10;Chievo Verona;1806;-4;1802
21/01/2018;Sampdoria;1885;14;1899;3 - 1;3;1;1;39;29;32;ACF Fiorentina;1951;-14;1937
21/01/2018;Sassuolo Calcio;1834;0;1834;1 - 1;1;1;X;34;29;37;Torino FC;1949;0;1949
21/01/2018;Cagliari Calcio;1805;-9;1796;1 - 2;1;2;2;32;29;39;AC Milan;1936;9;1945
21/01/2018;Udinese Calcio;1896;-7;1889;1 - 1;1;1;X;68;19;13;SPAL 2013 Ferrara;1702;7;1709
21/01/2018;Hellas Verona;1743;-23;1720;0 - 3;0;3;2;47;27;25;FC Crotone;1733;23;1756
21/01/2018;Bologna FC;1813;6;1819;3 - 0;3;0;1;68;19;13;Benevento Calcio;1623;-6;1617
06/01/2018;AS Roma;2132;-15;2117;1 - 2;1;2;2;57;24;19;Atalanta;2039;15;2054
06/01/2018;Cagliari Calcio;1807;-2;1805;0 - 1;0;1;2;10;16;74;Juventus;2258;2;2260
06/01/2018;SSC Napoli;2151;2;2153;2 - 0;2;0;1;84;12;5;Hellas Verona;1745;-2;1743
06/01/2018;Torino FC;1941;8;1949;3 - 0;3;0;1;60;23;17;Bologna FC;1821;-8;1813
06/01/2018;SPAL 2013 Ferrara;1709;-7;1702;2 - 5;2;5;2;16;21;63;Lazio Roma;2048;7;2055
06/01/2018;AC Milan;1933;3;1936;1 - 0;1;0;1;69;19;12;FC Crotone;1736;-3;1733
06/01/2018;Genoa CFC;1812;8;1820;1 - 0;1;0;1;43;29;29;Sassuolo Calcio;1842;-8;1834
06/01/2018;Benevento Calcio;1608;15;1623;3 - 2;3;2;1;19;24;57;Sampdoria;1900;-15;1885
05/01/2018;ACF Fiorentina;1952;-1;1951;1 - 1;1;1;X;39;29;32;Inter;2020;1;2021
05/01/2018;Chievo Verona;1806;0;1806;1 - 1;1;1;X;36;29;34;Udinese Calcio;1896;0;1896
30/12/2017;Inter;2022;-2;2020;0 - 0;0;0;X;43;28;28;Lazio Roma;2046;2;2048
30/12/2017;Hellas Verona;1748;-3;1745;1 - 3;1;3;2;8;14;78;Juventus;2252;3;2255
30/12/2017;AS Roma;2140;-8;2132;1 - 1;1;1;X;78;15;8;Sassuolo Calcio;1834;8;1842
30/12/2017;ACF Fiorentina;1956;-4;1952;1 - 1;1;1;X;49;27;24;AC Milan;1929;4;1933
30/12/2017;Atalanta;2041;-18;2023;1 - 2;1;2;2;74;17;10;Cagliari Calcio;1789;18;1807
30/12/2017;Torino FC;1950;-6;1944;0 - 0;0;0;X;63;21;15;Genoa CFC;1806;6;1812
30/12/2017;Bologna FC;1832;-11;1821;1 - 2;1;2;2;40;29;31;Udinese Calcio;1885;11;1896
30/12/2017;Sampdoria;1895;5;1900;2 - 0;2;0;1;67;20;13;SPAL 2013 Ferrara;1714;-5;1709
30/12/2017;Benevento Calcio;1595;13;1608;1 - 0;1;0;1;24;27;49;Chievo Verona;1819;-13;1806
29/12/2017;FC Crotone;1739;-3;1736;0 - 1;0;1;2;11;17;72;SSC Napoli;2164;3;2167
23/12/2017;Juventus;2247;5;2252;1 - 0;1;0;1;58;24;18;AS Roma;2145;-5;2140
23/12/2017;SSC Napoli;2162;2;2164;3 - 2;3;2;1;75;16;9;Sampdoria;1897;-2;1895
23/12/2017;AC Milan;1934;-15;1919;0 - 2;0;2;2;36;29;34;Atalanta;2026;15;2041
23/12/2017;Sassuolo Calcio;1821;13;1834;1 - 0;1;0;1;24;27;49;Inter;2045;-13;2032
23/12/2017;Lazio Roma;2037;4;2041;4 - 0;4;0;1;77;15;8;FC Crotone;1743;-4;1739
23/12/2017;SPAL 2013 Ferrara;1710;4;1714;2 - 2;2;2;X;23;26;52;Torino FC;1954;-4;1950
23/12/2017;Udinese Calcio;1877;8;1885;4 - 0;4;0;1;60;23;17;Hellas Verona;1756;-8;1748
23/12/2017;Genoa CFC;1803;3;1806;1 - 0;1;0;1;69;19;12;Benevento Calcio;1598;-3;1595
22/12/2017;Cagliari Calcio;1797;-8;1789;0 - 1;0;1;2;30;29;41;ACF Fiorentina;1953;8;1961
22/12/2017;Chievo Verona;1832;-13;1819;2 - 3;2;3;2;48;27;25;Bologna FC;1819;13;1832
17/12/2017;Bologna FC;1824;-5;1819;0 - 3;0;3;2;11;18;71;Juventus;2241;5;2246
17/12/2017;Atalanta;2026;-3;2023;3 - 3;3;3;X;45;28;27;Lazio Roma;2034;3;2037
17/12/2017;ACF Fiorentina;1959;-6;1953;0 - 0;0;0;X;65;21;14;Genoa CFC;1798;6;1804
17/12/2017;Sampdoria;1912;-15;1897;0 - 1;0;1;2;58;23;18;Sassuolo Calcio;1809;15;1824
17/12/2017;Hellas Verona;1732;24;1756;3 - 0;3;0;1;24;27;49;AC Milan;1958;-24;1934
17/12/2017;FC Crotone;1733;10;1743;1 - 0;1;0;1;34;29;36;Chievo Verona;1842;-10;1832
17/12/2017;Benevento Calcio;1608;-10;1598;1 - 2;1;2;2;36;29;34;SPAL 2013 Ferrara;1700;10;1710
16/12/2017;Torino FC;1948;-11;1937;1 - 3;1;3;2;26;28;46;SSC Napoli;2149;11;2160
16/12/2017;AS Roma;2161;1;2162;1 - 0;1;0;1;81;13;6;Cagliari Calcio;1798;-1;1797
16/12/2017;Inter;2071;-26;2045;1 - 3;1;3;2;71;18;11;Udinese Calcio;1853;26;1879
12/12/2017;Genoa CFC;1805;-7;1798;1 - 2;1;2;2;25;27;48;Atalanta;2019;7;2026
11/12/2017;Lazio Roma;2055;-24;2031;1 - 3;1;3;2;62;22;16;Torino FC;1924;24;1948
10/12/2017;SSC Napoli;2156;-7;2149;0 - 0;0;0;X;70;18;12;ACF Fiorentina;1946;7;1953
10/12/2017;Chievo Verona;1836;6;1842;0 - 0;0;0;X;16;22;62;AS Roma;2167;-6;2161
10/12/2017;AC Milan;1949;4;1953;2 - 1;2;1;1;60;23;17;Bologna FC;1828;-4;1824
10/12/2017;Sassuolo Calcio;1803;6;1809;2 - 1;2;1;1;54;25;21;FC Crotone;1739;-6;1733
10/12/2017;Udinese Calcio;1849;4;1853;2 - 0;2;0;1;72;17;10;Benevento Calcio;1612;-4;1608
10/12/2017;SPAL 2013 Ferrara;1702;-2;1700;2 - 2;2;2;X;42;29;29;Hellas Verona;1735;2;1737
09/12/2017;Juventus;2248;-7;2241;0 - 0;0;0;X;67;20;13;Inter;2064;7;2071
09/12/2017;Cagliari Calcio;1797;1;1798;2 - 2;2;2;X;33;29;38;Sampdoria;1919;-1;1918
04/12/2017;FC Crotone;1758;-19;1739;0 - 3;0;3;2;38;29;33;Udinese Calcio;1830;19;1849
04/12/2017;Hellas Verona;1747;-12;1735;0 - 1;0;1;2;41;29;30;Genoa CFC;1793;12;1805
03/12/2017;Sampdoria;1928;-9;1919;1 - 2;1;2;2;31;29;39;Lazio Roma;2067;9;2076
03/12/2017;Inter;2058;6;2064;5 - 0;5;0;1;70;18;11;Chievo Verona;1842;-6;1836
03/12/2017;ACF Fiorentina;1939;7;1946;3 - 0;3;0;1;61;22;16;Sassuolo Calcio;1810;-7;1803
03/12/2017;Bologna FC;1832;-4;1828;1 - 1;1;1;X;51;26;23;Cagliari Calcio;1793;4;1797
03/12/2017;Benevento Calcio;1605;7;1612;2 - 2;2;2;X;14;20;67;AC Milan;1981;-7;1974
02/12/2017;Torino FC;1924;0;1924;1 - 1;1;1;X;37;29;34;Atalanta;2009;0;2009
01/12/2017;SSC Napoli;2192;-12;2180;0 - 1;0;1;2;42;29;29;Juventus;2228;12;2240
01/12/2017;AS Roma;2164;1;2165;3 - 1;3;1;1;86;11;3;SPAL 2013 Ferrara;1703;-1;1702
27/11/2017;Atalanta;2008;1;2009;1 - 0;1;0;1;83;12;5;Benevento Calcio;1606;-1;1605
26/11/2017;Udinese Calcio;1826;-4;1822;0 - 1;0;1;2;14;20;65;SSC Napoli;2188;4;2192
26/11/2017;Lazio Roma;2073;-6;2067;1 - 1;1;1;X;63;22;16;ACF Fiorentina;1933;6;1939
26/11/2017;Juventus;2227;1;2228;3 - 0;3;0;1;86;11;3;FC Crotone;1766;-1;1765
26/11/2017;Genoa CFC;1779;7;1786;1 - 1;1;1;X;13;19;68;AS Roma;2171;-7;2164
26/11/2017;AC Milan;1985;-4;1981;0 - 0;0;0;X;54;25;21;Torino FC;1917;4;1921
25/11/2017;Cagliari Calcio;1802;-9;1793;1 - 3;1;3;2;22;26;52;Inter;2049;9;2058
25/11/2017;Bologna FC;1813;19;1832;3 - 0;3;0;1;32;29;38;Sampdoria;1943;-19;1924
25/11/2017;Chievo Verona;1843;4;1847;2 - 1;2;1;1;60;23;17;SPAL 2013 Ferrara;1728;-4;1724
25/11/2017;Sassuolo Calcio;1829;-23;1806;0 - 2;0;2;2;59;23;18;Hellas Verona;1719;23;1742
20/11/2017;Hellas Verona;1730;-11;1719;2 - 3;2;3;2;38;29;33;Bologna FC;1802;11;1813
19/11/2017;Sampdoria;1927;16;1943;3 - 2;3;2;1;17;23;60;Juventus;2244;-16;2228
19/11/2017;Inter;2040;9;2049;2 - 0;2;0;1;52;26;22;Atalanta;1992;-9;1983
19/11/2017;Torino FC;1922;-5;1917;1 - 1;1;1;X;56;24;19;Chievo Verona;1838;5;1843
19/11/2017;SPAL 2013 Ferrara;1725;3;1728;1 - 1;1;1;X;25;27;48;ACF Fiorentina;1936;-3;1933
19/11/2017;Udinese Calcio;1840;-14;1826;0 - 1;0;1;2;52;26;22;Cagliari Calcio;1788;14;1802
19/11/2017;FC Crotone;1779;-13;1766;0 - 1;0;1;2;48;27;25;Genoa CFC;1766;13;1779
19/11/2017;Benevento Calcio;1613;-7;1606;1 - 2;1;2;2;25;27;47;Sassuolo Calcio;1822;7;1829
18/11/2017;AS Roma;2184;5;2189;2 - 1;2;1;1;57;24;19;Lazio Roma;2089;-5;2084
18/11/2017;SSC Napoli;2173;3;2176;2 - 1;2;1;1;68;19;13;AC Milan;1983;-3;1980
05/11/2017;ACF Fiorentina;1946;-10;1936;2 - 4;2;4;2;24;27;50;AS Roma;2174;10;2184
05/11/2017;Chievo Verona;1832;6;1838;0 - 0;0;0;X;15;21;64;SSC Napoli;2179;-6;2173
05/11/2017;Inter;2046;-6;2040;1 - 1;1;1;X;61;22;16;Torino FC;1916;6;1922
05/11/2017;Juventus;2244;0;2244;2 - 1;2;1;1;90;9;1;Benevento Calcio;1613;0;1613
05/11/2017;Sassuolo Calcio;1835;-13;1822;0 - 2;0;2;2;32;29;39;AC Milan;1970;13;1983
05/11/2017;Atalanta;2000;-8;1992;1 - 1;1;1;X;76;15;8;SPAL 2013 Ferrara;1717;8;1725
05/11/2017;Cagliari Calcio;1782;6;1788;2 - 1;2;1;1;52;26;22;Hellas Verona;1736;-6;1730
04/11/2017;Genoa CFC;1780;-14;1766;0 - 2;0;2;2;32;29;39;Sampdoria;1913;14;1927
04/11/2017;Bologna FC;1816;-14;1802;2 - 3;2;3;2;52;26;22;FC Crotone;1765;14;1779
30/10/2017;Hellas Verona;1741;-5;1736;1 - 2;1;2;2;18;23;58;Inter;2041;5;2046
29/10/2017;SSC Napoli;2204;2;2206;3 - 1;3;1;1;82;13;6;Sassuolo Calcio;1837;-2;1835
29/10/2017;Udinese Calcio;1828;12;1840;2 - 1;2;1;1;27;28;45;Atalanta;2016;-12;2004
29/10/2017;Sampdoria;1903;10;1913;4 - 1;4;1;1;53;25;21;Chievo Verona;1842;-10;1832
29/10/2017;FC Crotone;1752;13;1765;2 - 1;2;1;1;25;27;47;ACF Fiorentina;1959;-13;1946
29/10/2017;Benevento Calcio;1617;-4;1613;1 - 5;1;5;2;9;16;75;Lazio Roma;2081;4;2085
29/10/2017;Torino FC;1912;4;1916;2 - 1;2;1;1;61;22;17;Cagliari Calcio;1786;-4;1782
29/10/2017;SPAL 2013 Ferrara;1707;10;1717;1 - 0;1;0;1;37;29;34;Genoa CFC;1790;-10;1780
28/10/2017;AC Milan;1980;-8;1972;0 - 2;0;2;2;21;25;54;Juventus;2243;8;2251
28/10/2017;AS Roma;2149;2;2151;1 - 0;1;0;1;79;14;7;Bologna FC;1818;-2;1816
25/10/2017;Genoa CFC;1793;-3;1790;2 - 3;2;3;2;12;18;70;SSC Napoli;2201;3;2204
25/10/2017;Juventus;2242;1;2243;4 - 1;4;1;1;88;10;2;SPAL 2013 Ferrara;1708;-1;1707
25/10/2017;AS Roma;2148;1;2149;1 - 0;1;0;1;83;12;5;FC Crotone;1753;-1;1752
25/10/2017;Bologna FC;1824;-6;1818;1 - 2;1;2;2;22;26;52;Lazio Roma;2075;6;2081
25/10/2017;ACF Fiorentina;1947;12;1959;3 - 0;3;0;1;49;27;24;Torino FC;1924;-12;1912
25/10/2017;Chievo Verona;1859;-17;1842;1 - 4;1;4;2;35;29;36;AC Milan;1963;17;1980
25/10/2017;Atalanta;2012;4;2016;3 - 0;3;0;1;75;16;9;Hellas Verona;1745;-4;1741
25/10/2017;Sassuolo Calcio;1851;-14;1837;0 - 1;0;1;2;51;26;23;Udinese Calcio;1814;14;1828
25/10/2017;Cagliari Calcio;1782;4;1786;2 - 1;2;1;1;65;21;14;Benevento Calcio;1621;-4;1617
24/10/2017;Inter;2037;4;2041;3 - 2;3;2;1;61;22;16;Sampdoria;1907;-4;1903
22/10/2017;Torino FC;1931;-7;1924;0 - 1;0;1;2;25;27;48;AS Roma;2141;7;2148
22/10/2017;Udinese Calcio;1819;-5;1814;2 - 6;2;6;2;11;18;71;Juventus;2237;5;2242
22/10/2017;Lazio Roma;2072;3;2075;3 - 0;3;0;1;76;15;8;Cagliari Calcio;1785;-3;1782
22/10/2017;Atalanta;2009;3;2012;1 - 0;1;0;1;67;20;13;Bologna FC;1827;-3;1824
22/10/2017;AC Milan;1970;-7;1963;0 - 0;0;0;X;67;20;13;Genoa CFC;1786;7;1793
22/10/2017;Chievo Verona;1854;5;1859;3 - 2;3;2;1;58;23;18;Hellas Verona;1750;-5;1745
22/10/2017;Benevento Calcio;1629;-8;1621;0 - 3;0;3;2;18;23;59;ACF Fiorentina;1939;8;1947
22/10/2017;SPAL 2013 Ferrara;1717;-9;1708;0 - 1;0;1;2;33;29;38;Sassuolo Calcio;1842;9;1851
21/10/2017;SSC Napoli;2208;-7;2201;0 - 0;0;0;X;67;20;13;Inter;2030;7;2037
21/10/2017;Sampdoria;1899;8;1907;5 - 0;5;0;1;62;22;16;FC Crotone;1761;-8;1753
16/10/2017;Hellas Verona;1745;5;1750;1 - 0;1;0;1;59;23;18;Benevento Calcio;1634;-5;1629
15/10/2017;Inter;2024;6;2030;3 - 2;3;2;1;51;26;23;AC Milan;1984;-6;1978
15/10/2017;Sampdoria;1882;17;1899;3 - 1;3;1;1;32;29;39;Atalanta;2020;-17;2003
15/10/2017;ACF Fiorentina;1934;5;1939;2 - 1;2;1;1;59;23;18;Udinese Calcio;1824;-5;1819
15/10/2017;Sassuolo Calcio;1845;-3;1842;0 - 0;0;0;X;46;28;27;Chievo Verona;1851;3;1854
15/10/2017;FC Crotone;1759;2;1761;2 - 2;2;2;X;28;28;43;Torino FC;1933;-2;1931
15/10/2017;Cagliari Calcio;1798;-13;1785;2 - 3;2;3;2;49;27;24;Genoa CFC;1773;13;1786
15/10/2017;Bologna FC;1822;5;1827;2 - 1;2;1;1;58;24;18;SPAL 2013 Ferrara;1722;-5;1717
14/10/2017;AS Roma;2145;-11;2134;0 - 1;0;1;2;39;29;32;SSC Napoli;2207;11;2218
14/10/2017;Juventus;2251;-17;2234;1 - 2;1;2;2;70;18;12;Lazio Roma;2038;17;2055
01/10/2017;Atalanta;2016;4;2020;2 - 2;2;2;X;23;26;51;Juventus;2255;-4;2251
01/10/2017;AC Milan;1997;-13;1984;0 - 2;0;2;2;32;29;39;AS Roma;2132;13;2145
01/10/2017;SSC Napoli;2205;2;2207;3 - 0;3;0;1;83;12;5;Cagliari Calcio;1800;-2;1798
01/10/2017;Lazio Roma;2031;7;2038;6 - 1;6;1;1;67;20;13;Sassuolo Calcio;1852;-7;1845
01/10/2017;Chievo Verona;1841;10;1851;2 - 1;2;1;1;35;29;36;ACF Fiorentina;1944;-10;1934
01/10/2017;Torino FC;1940;-7;1933;2 - 2;2;2;X;69;19;12;Hellas Verona;1738;7;1745
01/10/2017;Benevento Calcio;1637;-3;1634;1 - 2;1;2;2;13;19;68;Inter;2021;3;2024
01/10/2017;SPAL 2013 Ferrara;1724;-2;1722;1 - 1;1;1;X;42;29;29;FC Crotone;1757;2;1759
30/09/2017;Udinese Calcio;1805;19;1824;4 - 0;4;0;1;36;29;35;Sampdoria;1901;-19;1882
30/09/2017;Genoa CFC;1785;-12;1773;0 - 1;0;1;2;43;28;28;Bologna FC;1810;12;1822
24/09/2017;ACF Fiorentina;1945;-1;1944;1 - 1;1;1;X;39;29;32;Atalanta;2012;1;2013
24/09/2017;Sampdoria;1885;16;1901;2 - 0;2;0;1;33;29;38;AC Milan;2008;-16;1992
24/09/2017;Inter;2018;3;2021;1 - 0;1;0;1;72;18;11;Genoa CFC;1788;-3;1785
24/09/2017;Hellas Verona;1748;-10;1738;0 - 3;0;3;2;21;25;55;Lazio Roma;2017;10;2027
24/09/2017;Sassuolo Calcio;1867;-15;1852;0 - 1;0;1;2;55;25;20;Bologna FC;1795;15;1810
24/09/2017;Cagliari Calcio;1819;-19;1800;0 - 2;0;2;2;46;28;26;Chievo Verona;1822;19;1841
24/09/2017;FC Crotone;1750;7;1757;2 - 0;2;0;1;59;23;18;Benevento Calcio;1644;-7;1637
23/09/2017;Juventus;2249;3;2252;4 - 0;4;0;1;78;15;8;Torino FC;1943;-3;1940
23/09/2017;AS Roma;2125;2;2127;3 - 1;3;1;1;79;14;7;Udinese Calcio;1807;-2;1805
23/09/2017;SPAL 2013 Ferrara;1726;-2;1724;2 - 3;2;3;2;9;15;76;SSC Napoli;2200;2;2202
20/09/2017;Lazio Roma;2032;-15;2017;1 - 4;1;4;2;30;29;41;SSC Napoli;2185;15;2200
20/09/2017;Juventus;2247;2;2249;1 - 0;1;0;1;77;15;8;ACF Fiorentina;1947;-2;1945
20/09/2017;Benevento Calcio;1648;-4;1644;0 - 4;0;4;2;9;15;76;AS Roma;2121;4;2125
20/09/2017;Atalanta;2008;4;2012;5 - 1;5;1;1;74;17;10;FC Crotone;1754;-4;1750
20/09/2017;Udinese Calcio;1817;-10;1807;2 - 3;2;3;2;34;29;37;Torino FC;1933;10;1943
20/09/2017;AC Milan;2005;3;2008;2 - 0;2;0;1;76;16;9;SPAL 2013 Ferrara;1729;-3;1726
20/09/2017;Cagliari Calcio;1831;-12;1819;0 - 1;0;1;2;43;28;28;Sassuolo Calcio;1855;12;1867
20/09/2017;Hellas Verona;1747;1;1748;0 - 0;0;0;X;31;29;39;Sampdoria;1886;-1;1885
20/09/2017;Genoa CFC;1790;-2;1788;1 - 1;1;1;X;43;29;29;Chievo Verona;1820;2;1822
19/09/2017;Bologna FC;1791;4;1795;1 - 1;1;1;X;24;26;50;Inter;2022;-4;2018
17/09/2017;Sassuolo Calcio;1860;-5;1855;1 - 3;1;3;2;13;19;67;Juventus;2242;5;2247
17/09/2017;SSC Napoli;2184;1;2185;6 - 0;6;0;1;88;10;2;Benevento Calcio;1649;-1;1648
17/09/2017;Chievo Verona;1817;3;1820;1 - 1;1;1;X;27;28;46;Atalanta;2011;-3;2008
17/09/2017;AC Milan;2002;3;2005;2 - 1;2;1;1;67;20;13;Udinese Calcio;1820;-3;1817
17/09/2017;Genoa CFC;1796;-6;1790;2 - 3;2;3;2;24;27;50;Lazio Roma;2026;6;2032
17/09/2017;Torino FC;1937;-4;1933;2 - 2;2;2;X;53;26;22;Sampdoria;1882;4;1886
17/09/2017;SPAL 2013 Ferrara;1745;-16;1729;0 - 2;0;2;2;38;29;32;Cagliari Calcio;1815;16;1831
16/09/2017;AS Roma;2119;2;2121;3 - 0;3;0;1;82;13;5;Hellas Verona;1749;-2;1747
16/09/2017;FC Crotone;1763;-9;1754;0 - 2;0;2;2;22;26;52;Inter;2013;9;2022
16/09/2017;ACF Fiorentina;1943;4;1947;2 - 1;2;1;1;63;21;15;Bologna FC;1795;-4;1791
10/09/2017;Lazio Roma;2006;12;2018;4 - 1;4;1;1;47;28;25;AC Milan;2000;-12;1988
10/09/2017;Bologna FC;1800;-5;1795;0 - 3;0;3;2;13;19;69;SSC Napoli;2195;5;2200
10/09/2017;Atalanta;1991;4;1995;2 - 1;2;1;1;61;22;17;Sassuolo Calcio;1864;-4;1860
10/09/2017;Inter;2010;3;2013;2 - 0;2;0;1;74;16;9;SPAL 2013 Ferrara;1748;-3;1745
10/09/2017;Hellas Verona;1766;-17;1749;0 - 5;0;5;2;30;29;42;ACF Fiorentina;1926;17;1943
10/09/2017;Udinese Calcio;1813;7;1820;1 - 0;1;0;1;47;27;25;Genoa CFC;1803;-7;1796
10/09/2017;Benevento Calcio;1654;-5;1649;0 - 1;0;1;2;20;24;56;Torino FC;1932;5;1937
10/09/2017;Cagliari Calcio;1809;6;1815;1 - 0;1;0;1;51;26;23;FC Crotone;1769;-6;1763
09/09/2017;Juventus;2258;2;2260;3 - 0;3;0;1;85;11;4;Chievo Verona;1819;-2;1817
27/08/2017;SSC Napoli;2190;5;2195;3 - 1;3;1;1;68;19;13;Atalanta;1996;-5;1991
27/08/2017;Chievo Verona;1827;-8;1819;1 - 2;1;2;2;29;28;43;Lazio Roma;1998;8;2006
27/08/2017;AC Milan;1997;3;2000;2 - 1;2;1;1;67;20;13;Cagliari Calcio;1812;-3;1809
27/08/2017;ACF Fiorentina;1941;-15;1926;1 - 2;1;2;2;55;25;20;Sampdoria;1867;15;1882
27/08/2017;Torino FC;1922;10;1932;3 - 0;3;0;1;52;26;22;Sassuolo Calcio;1874;-10;1864
27/08/2017;SPAL 2013 Ferrara;1738;10;1748;3 - 2;3;2;1;37;29;34;Udinese Calcio;1823;-10;1813
27/08/2017;FC Crotone;1772;-3;1769;0 - 0;0;0;X;47;27;25;Hellas Verona;1763;3;1766
26/08/2017;AS Roma;2145;-25;2120;1 - 3;1;3;2;65;21;15;Inter;1985;25;2010
26/08/2017;Genoa CFC;1807;-4;1803;2 - 4;2;4;2;10;16;74;Juventus;2254;4;2258
26/08/2017;Benevento Calcio;1663;-9;1654;0 - 1;0;1;2;33;29;38;Bologna FC;1791;9;1800
20/08/2017;Atalanta;2005;-9;1996;0 - 1;0;1;2;32;29;39;AS Roma;2136;9;2145
20/08/2017;Inter;1973;12;1985;3 - 0;3;0;1;49;27;24;ACF Fiorentina;1953;-12;1941
20/08/2017;FC Crotone;1785;-13;1772;0 - 3;0;3;2;26;28;46;AC Milan;1981;13;1994
20/08/2017;Lazio Roma;2006;-8;1998;0 - 0;0;0;X;76;16;9;SPAL 2013 Ferrara;1730;8;1738
20/08/2017;Bologna FC;1790;1;1791;1 - 1;1;1;X;32;29;39;Torino FC;1923;-1;1922
20/08/2017;Sassuolo Calcio;1879;-5;1874;0 - 0;0;0;X;55;25;20;Genoa CFC;1802;5;1807
20/08/2017;Udinese Calcio;1836;-13;1823;1 - 2;1;2;2;49;27;24;Chievo Verona;1814;13;1827
20/08/2017;Sampdoria;1864;3;1867;2 - 1;2;1;1;69;19;12;Benevento Calcio;1666;-3;1663
19/08/2017;Juventus;2252;2;2254;3 - 0;3;0;1;85;11;4;Cagliari Calcio;1814;-2;1812
19/08/2017;Hellas Verona;1767;-4;1763;1 - 3;1;3;2;12;18;70;SSC Napoli;2175;4;2179
28/05/2017;Sampdoria;1871;-7;1864;2 - 4;2;4;2;19;24;57;SSC Napoli;2163;7;2170
28/05/2017;AS Roma;2134;2;2136;3 - 2;3;2;1;80;14;7;Genoa CFC;1799;-2;1797
28/05/2017;Inter;1966;7;1973;5 - 2;5;2;1;61;22;16;Udinese Calcio;1838;-7;1831
28/05/2017;Torino FC;1908;10;1918;5 - 3;5;3;1;49;27;24;Sassuolo Calcio;1884;-10;1874
28/05/2017;Cagliari Calcio;1807;12;1819;2 - 1;2;1;1;28;28;43;AC Milan;1982;-12;1970
28/05/2017;FC Crotone;1760;21;1781;3 - 1;3;1;1;22;26;53;Lazio Roma;2012;-21;1991
28/05/2017;ACF Fiorentina;1961;-8;1953;2 - 2;2;2;X;77;15;8;Pescara Calcio;1661;8;1669
28/05/2017;US Palermo;1714;9;1723;2 - 1;2;1;1;41;29;30;Empoli FC;1763;-9;1754
27/05/2017;Bologna FC;1821;-2;1819;1 - 2;1;2;2;9;16;75;Juventus;2288;2;2290
27/05/2017;Atalanta;2002;3;2005;1 - 0;1;0;1;68;19;13;Chievo Verona;1814;-3;1811
22/05/2017;Pescara Calcio;1647;14;1661;2 - 0;2;0;1;37;29;33;US Palermo;1728;-14;1714
21/05/2017;Juventus;2287;1;2288;3 - 0;3;0;1;88;10;2;FC Crotone;1761;-1;1760
21/05/2017;Lazio Roma;2034;-22;2012;1 - 3;1;3;2;57;24;19;Inter;1944;22;1966
21/05/2017;AC Milan;1975;7;1982;3 - 0;3;0;1;63;21;15;Bologna FC;1828;-7;1821
21/05/2017;Empoli FC;1769;-6;1763;0 - 1;0;1;2;24;27;50;Atalanta;1996;6;2002
21/05/2017;Udinese Calcio;1840;-2;1838;1 - 1;1;1;X;43;29;29;Sampdoria;1869;2;1871
21/05/2017;Genoa CFC;1788;11;1799;2 - 1;2;1;1;32;29;39;Torino FC;1919;-11;1908
21/05/2017;Sassuolo Calcio;1873;11;1884;6 - 2;6;2;1;53;26;22;Cagliari Calcio;1818;-11;1807
20/05/2017;SSC Napoli;2157;6;2163;4 - 1;4;1;1;68;19;13;ACF Fiorentina;1967;-6;1961
20/05/2017;Chievo Verona;1821;-7;1814;3 - 5;3;5;2;18;23;59;AS Roma;2127;7;2134
14/05/2017;AS Roma;2108;19;2127;3 - 1;3;1;1;27;28;45;Juventus;2296;-19;2277
14/05/2017;Torino FC;1933;-14;1919;0 - 5;0;5;2;25;27;48;SSC Napoli;2143;14;2157
14/05/2017;Inter;1959;-15;1944;1 - 2;1;2;2;58;24;18;Sassuolo Calcio;1858;15;1873
14/05/2017;Sampdoria;1873;-4;1869;1 - 1;1;1;X;53;26;22;Chievo Verona;1817;4;1821
14/05/2017;FC Crotone;1751;10;1761;1 - 0;1;0;1;35;29;35;Udinese Calcio;1850;-10;1840
14/05/2017;Cagliari Calcio;1812;6;1818;3 - 2;3;2;1;51;26;23;Empoli FC;1775;-6;1769
14/05/2017;US Palermo;1719;9;1728;1 - 0;1;0;1;38;29;33;Genoa CFC;1797;-9;1788
14/05/2017;Bologna FC;1823;5;1828;3 - 1;3;1;1;66;20;14;Pescara Calcio;1652;-5;1647
13/05/2017;ACF Fiorentina;1957;10;1967;3 - 2;3;2;1;36;29;35;Lazio Roma;2054;-10;2044
13/05/2017;Atalanta;2000;-4;1996;1 - 1;1;1;X;50;27;24;AC Milan;1971;4;1975
07/05/2017;AC Milan;1988;-17;1971;1 - 4;1;4;2;35;29;36;AS Roma;2091;17;2108
07/05/2017;Lazio Roma;2047;7;2054;7 - 3;7;3;1;66;20;14;Sampdoria;1880;-7;1873
07/05/2017;Udinese Calcio;1849;1;1850;1 - 1;1;1;X;30;29;41;Atalanta;2001;-1;2000
07/05/2017;Sassuolo Calcio;1858;0;1858;2 - 2;2;2;X;35;29;35;ACF Fiorentina;1957;0;1957
07/05/2017;Genoa CFC;1785;12;1797;1 - 0;1;0;1;27;28;45;Inter;1971;-12;1959
07/05/2017;Empoli FC;1761;14;1775;3 - 1;3;1;1;38;29;33;Bologna FC;1837;-14;1823
07/05/2017;Chievo Verona;1822;-5;1817;1 - 1;1;1;X;59;23;18;US Palermo;1714;5;1719
07/05/2017;Pescara Calcio;1663;-11;1652;0 - 1;0;1;2;38;29;33;FC Crotone;1740;11;1751
06/05/2017;Juventus;2299;-9;2290;1 - 1;1;1;X;82;13;5;Torino FC;1924;9;1933
06/05/2017;SSC Napoli;2141;2;2143;3 - 1;3;1;1;79;14;7;Cagliari Calcio;1814;-2;1812
30/04/2017;AS Roma;2113;-22;2091;1 - 3;1;3;2;57;24;19;Lazio Roma;2025;22;2047
30/04/2017;Inter;1979;-8;1971;0 - 1;0;1;2;30;29;41;SSC Napoli;2133;8;2141
30/04/2017;FC Crotone;1736;4;1740;1 - 1;1;1;X;22;25;53;AC Milan;1992;-4;1988
30/04/2017;Bologna FC;1821;16;1837;4 - 0;4;0;1;41;29;30;Udinese Calcio;1865;-16;1849
30/04/2017;US Palermo;1692;22;1714;2 - 0;2;0;1;19;24;57;ACF Fiorentina;1979;-22;1957
30/04/2017;Empoli FC;1778;-17;1761;1 - 3;1;3;2;39;29;32;Sassuolo Calcio;1841;17;1858
30/04/2017;Genoa CFC;1797;-12;1785;1 - 2;1;2;2;45;28;27;Chievo Verona;1810;12;1822
30/04/2017;Cagliari Calcio;1810;4;1814;1 - 0;1;0;1;63;22;16;Pescara Calcio;1667;-4;1663
29/04/2017;Torino FC;1928;-4;1924;1 - 1;1;1;X;52;26;22;Sampdoria;1876;4;1880
28/04/2017;Atalanta;1996;5;2001;2 - 2;2;2;X;19;24;57;Juventus;2283;-5;2278
24/04/2017;Pescara Calcio;1671;-4;1667;1 - 4;1;4;2;10;17;73;AS Roma;2109;4;2113
23/04/2017;Juventus;2282;1;2283;4 - 0;4;0;1;87;10;3;Genoa CFC;1798;-1;1797
23/04/2017;Sassuolo Calcio;1836;5;1841;2 - 2;2;2;X;18;23;58;SSC Napoli;2138;-5;2133
23/04/2017;AC Milan;2010;-18;1992;1 - 2;1;2;2;73;17;10;Empoli FC;1760;18;1778
23/04/2017;Chievo Verona;1826;-16;1810;1 - 3;1;3;2;37;29;34;Torino FC;1912;16;1928
23/04/2017;Lazio Roma;2022;3;2025;6 - 2;6;2;1;79;14;7;US Palermo;1695;-3;1692
23/04/2017;Udinese Calcio;1859;6;1865;2 - 1;2;1;1;51;26;23;Cagliari Calcio;1816;-6;1810
23/04/2017;Sampdoria;1893;-17;1876;1 - 2;1;2;2;66;20;14;FC Crotone;1719;17;1736
22/04/2017;ACF Fiorentina;1971;8;1979;5 - 4;5;4;1;44;28;27;Inter;1987;-8;1979
22/04/2017;Atalanta;1992;4;1996;3 - 2;3;2;1;66;20;14;Bologna FC;1825;-4;1821
15/04/2017;AS Roma;2115;-6;2109;1 - 1;1;1;X;61;22;16;Atalanta;1986;6;1992
15/04/2017;SSC Napoli;2134;4;2138;3 - 0;3;0;1;75;16;9;Udinese Calcio;1863;-4;1859
15/04/2017;Inter;1989;-2;1987;2 - 2;2;2;X;44;28;28;AC Milan;2008;2;2010
15/04/2017;Pescara Calcio;1673;-2;1671;0 - 2;0;2;2;5;11;84;Juventus;2277;2;2279
15/04/2017;Genoa CFC;1794;4;1798;2 - 2;2;2;X;23;26;50;Lazio Roma;2026;-4;2022
15/04/2017;ACF Fiorentina;1989;-18;1971;1 - 2;1;2;2;73;17;10;Empoli FC;1742;18;1760
15/04/2017;Sassuolo Calcio;1827;9;1836;2 - 1;2;1;1;38;29;33;Sampdoria;1902;-9;1893
15/04/2017;Cagliari Calcio;1800;16;1816;4 - 0;4;0;1;41;29;30;Chievo Verona;1842;-16;1826
15/04/2017;Torino FC;1919;-7;1912;1 - 1;1;1;X;70;19;12;FC Crotone;1712;7;1719
15/04/2017;US Palermo;1694;1;1695;0 - 0;0;0;X;32;29;39;Bologna FC;1826;-1;1825
09/04/2017;Lazio Roma;2045;-19;2026;0 - 3;0;3;2;38;29;32;SSC Napoli;2115;19;2134
09/04/2017;Bologna FC;1836;-10;1826;0 - 3;0;3;2;21;25;55;AS Roma;2105;10;2115
09/04/2017;Sampdoria;1902;0;1902;2 - 2;2;2;X;37;29;34;ACF Fiorentina;1989;0;1989
09/04/2017;Cagliari Calcio;1810;-10;1800;2 - 3;2;3;2;35;29;35;Torino FC;1909;10;1919
09/04/2017;AC Milan;2005;3;2008;4 - 0;4;0;1;78;15;7;US Palermo;1697;-3;1694
09/04/2017;FC Crotone;1697;15;1712;2 - 1;2;1;1;18;23;59;Inter;2004;-15;1989
09/04/2017;Udinese Calcio;1852;11;1863;3 - 0;3;0;1;52;26;22;Genoa CFC;1805;-11;1794
08/04/2017;Juventus;2255;2;2257;2 - 0;2;0;1;84;12;4;Chievo Verona;1844;-2;1842
08/04/2017;Atalanta;1993;-7;1986;1 - 1;1;1;X;66;20;14;Sassuolo Calcio;1820;7;1827
08/04/2017;Empoli FC;1747;-5;1742;1 - 1;1;1;X;56;25;20;Pescara Calcio;1668;5;1673
03/04/2017;Inter;2020;-16;2004;1 - 2;1;2;2;62;22;16;Sampdoria;1886;16;1902
02/04/2017;SSC Napoli;2101;2;2103;1 - 1;1;1;X;29;29;43;Juventus;2269;-2;2267
02/04/2017;ACF Fiorentina;1985;4;1989;1 - 0;1;0;1;63;21;15;Bologna FC;1840;-4;1836
02/04/2017;Genoa CFC;1822;-17;1805;0 - 5;0;5;2;30;29;41;Atalanta;1976;17;1993
02/04/2017;Torino FC;1913;-4;1909;2 - 2;2;2;X;54;25;21;Udinese Calcio;1848;4;1852
02/04/2017;Pescara Calcio;1662;6;1668;1 - 1;1;1;X;15;21;64;AC Milan;2011;-6;2005
02/04/2017;Chievo Verona;1861;-17;1844;1 - 2;1;2;2;67;20;13;FC Crotone;1680;17;1697
02/04/2017;US Palermo;1713;-16;1697;1 - 3;1;3;2;37;29;33;Cagliari Calcio;1794;16;1810
01/04/2017;Sassuolo Calcio;1827;-7;1820;1 - 2;1;2;2;25;27;48;Lazio Roma;2044;7;2051
01/04/2017;AS Roma;2097;2;2099;2 - 0;2;0;1;81;13;6;Empoli FC;1749;-2;1747
19/03/2017;Sampdoria;1889;-3;1886;0 - 1;0;1;2;14;20;67;Juventus;2266;3;2269
19/03/2017;AS Roma;2094;3;2097;3 - 1;3;1;1;75;16;9;Sassuolo Calcio;1830;-3;1827
19/03/2017;Empoli FC;1753;-4;1749;2 - 3;2;3;2;16;21;63;SSC Napoli;2097;4;2101
19/03/2017;Cagliari Calcio;1790;4;1794;0 - 0;0;0;X;21;25;53;Lazio Roma;2048;-4;2044
19/03/2017;Bologna FC;1825;15;1840;4 - 1;4;1;1;40;29;31;Chievo Verona;1876;-15;1861
19/03/2017;FC Crotone;1685;-5;1680;0 - 1;0;1;2;19;24;58;ACF Fiorentina;1980;5;1985
19/03/2017;Atalanta;1973;3;1976;3 - 0;3;0;1;78;15;7;Pescara Calcio;1665;-3;1662
19/03/2017;Udinese Calcio;1840;8;1848;4 - 1;4;1;1;60;23;17;US Palermo;1721;-8;1713
18/03/2017;Torino FC;1913;0;1913;2 - 2;2;2;X;35;29;36;Inter;2020;0;2020
18/03/2017;AC Milan;2008;3;2011;1 - 0;1;0;1;67;20;13;Genoa CFC;1825;-3;1822
13/03/2017;Lazio Roma;2041;7;2048;3 - 1;3;1;1;60;23;17;Torino FC;1920;-7;1913
12/03/2017;Inter;2006;14;2020;7 - 1;7;1;1;48;27;24;Atalanta;1987;-14;1973
12/03/2017;US Palermo;1728;-7;1721;0 - 3;0;3;2;15;21;64;AS Roma;2080;7;2087
12/03/2017;SSC Napoli;2095;2;2097;3 - 0;3;0;1;84;12;4;FC Crotone;1687;-2;1685
12/03/2017;ACF Fiorentina;1977;3;1980;1 - 0;1;0;1;67;20;13;Cagliari Calcio;1793;-3;1790
12/03/2017;Sassuolo Calcio;1844;-14;1830;0 - 1;0;1;2;50;27;23;Bologna FC;1811;14;1825
12/03/2017;Chievo Verona;1867;9;1876;4 - 0;4;0;1;59;23;18;Empoli FC;1762;-9;1753
12/03/2017;Pescara Calcio;1678;-13;1665;1 - 3;1;3;2;31;29;40;Udinese Calcio;1827;13;1840
11/03/2017;Genoa CFC;1837;-12;1825;0 - 1;0;1;2;42;29;30;Sampdoria;1877;12;1889
10/03/2017;Juventus;2260;2;2262;2 - 1;2;1;1;73;17;10;AC Milan;2010;-2;2008
05/03/2017;Udinese Calcio;1819;8;1827;1 - 1;1;1;X;10;16;74;Juventus;2268;-8;2260
05/03/2017;Atalanta;1990;-3;1987;0 - 0;0;0;X;48;27;25;ACF Fiorentina;1974;3;1977
05/03/2017;Bologna FC;1821;-10;1811;0 - 2;0;2;2;25;27;48;Lazio Roma;2031;10;2041
05/03/2017;Cagliari Calcio;1807;-14;1793;1 - 5;1;5;2;27;28;45;Inter;1992;14;2006
05/03/2017;Torino FC;1915;5;1920;3 - 1;3;1;1;67;20;13;US Palermo;1733;-5;1728
05/03/2017;Empoli FC;1780;-18;1762;0 - 2;0;2;2;42;29;29;Genoa CFC;1819;18;1837
05/03/2017;FC Crotone;1685;2;1687;0 - 0;0;0;X;29;29;42;Sassuolo Calcio;1846;-2;1844
04/03/2017;AS Roma;2112;-13;2099;1 - 2;1;2;2;48;27;25;SSC Napoli;2100;13;2113
04/03/2017;AC Milan;2004;6;2010;3 - 1;3;1;1;62;22;16;Chievo Verona;1873;-6;1867
04/03/2017;Sampdoria;1872;5;1877;3 - 1;3;1;1;68;19;13;Pescara Calcio;1683;-5;1678
27/02/2017;ACF Fiorentina;1979;-5;1974;2 - 2;2;2;X;54;25;21;Torino FC;1910;5;1915
26/02/2017;Inter;2007;-15;1992;1 - 3;1;3;2;35;29;36;AS Roma;2112;15;2127
26/02/2017;Sassuolo Calcio;1855;-9;1846;0 - 1;0;1;2;31;29;40;AC Milan;1995;9;2004
26/02/2017;Lazio Roma;2013;3;2016;1 - 0;1;0;1;68;19;13;Udinese Calcio;1822;-3;1819
26/02/2017;Genoa CFC;1822;-3;1819;1 - 1;1;1;X;47;28;26;Bologna FC;1818;3;1821
26/02/2017;US Palermo;1732;1;1733;1 - 1;1;1;X;31;29;40;Sampdoria;1873;-1;1872
26/02/2017;Chievo Verona;1868;5;1873;2 - 0;2;0;1;67;20;13;Pescara Calcio;1688;-5;1683
26/02/2017;FC Crotone;1695;-10;1685;1 - 2;1;2;2;35;29;35;Cagliari Calcio;1797;10;1807
25/02/2017;SSC Napoli;2131;-25;2106;0 - 2;0;2;2;65;20;14;Atalanta;1965;25;1990
25/02/2017;Juventus;2261;1;2262;2 - 0;2;0;1;86;11;3;Empoli FC;1781;-1;1780
19/02/2017;AS Roma;2128;5;2133;4 - 1;4;1;1;70;18;12;Torino FC;1915;-5;1910
19/02/2017;AC Milan;1987;8;1995;2 - 1;2;1;1;43;29;28;ACF Fiorentina;2014;-8;2006
19/02/2017;Chievo Verona;1877;-9;1868;1 - 3;1;3;2;22;26;52;SSC Napoli;2122;9;2131
19/02/2017;Bologna FC;1826;-8;1818;0 - 1;0;1;2;28;28;43;Inter;1999;8;2007
19/02/2017;Udinese Calcio;1835;-13;1822;1 - 2;1;2;2;45;28;27;Sassuolo Calcio;1842;13;1855
19/02/2017;Sampdoria;1878;-5;1873;1 - 1;1;1;X;56;24;19;Cagliari Calcio;1792;5;1797
19/02/2017;Pescara Calcio;1663;25;1688;5 - 0;5;0;1;27;28;44;Genoa CFC;1847;-25;1822
18/02/2017;Empoli FC;1788;-7;1781;1 - 2;1;2;2;25;27;48;Lazio Roma;2006;7;2013
18/02/2017;Atalanta;1963;2;1965;1 - 0;1;0;1;75;16;9;FC Crotone;1697;-2;1695
17/02/2017;Juventus;2246;1;2247;4 - 1;4;1;1;87;10;3;US Palermo;1733;-1;1732
13/02/2017;Lazio Roma;2010;-4;2006;1 - 1;1;1;X;49;27;24;AC Milan;1983;4;1987
12/02/2017;Cagliari Calcio;1796;-4;1792;0 - 2;0;2;2;10;16;73;Juventus;2242;4;2246
12/02/2017;FC Crotone;1702;-5;1697;0 - 2;0;2;2;12;18;69;AS Roma;2103;5;2108
12/02/2017;Inter;1994;5;1999;2 - 0;2;0;1;69;19;12;Empoli FC;1793;-5;1788
12/02/2017;Sassuolo Calcio;1861;-19;1842;1 - 3;1;3;2;47;28;26;Chievo Verona;1858;19;1877
12/02/2017;Sampdoria;1869;9;1878;3 - 1;3;1;1;50;27;23;Bologna FC;1835;-9;1826
12/02/2017;US Palermo;1743;-10;1733;1 - 3;1;3;2;25;27;48;Atalanta;1953;10;1963
12/02/2017;Torino FC;1911;4;1915;5 - 3;5;3;1;73;17;10;Pescara Calcio;1667;-4;1663
11/02/2017;ACF Fiorentina;1992;7;1999;3 - 0;3;0;1;64;21;15;Udinese Calcio;1842;-7;1835
10/02/2017;SSC Napoli;2128;3;2131;2 - 0;2;0;1;76;16;9;Genoa CFC;1850;-3;1847
08/02/2017;FC Crotone;1704;-2;1702;0 - 2;0;2;2;7;13;80;Juventus;2240;2;2242
08/02/2017;Bologna FC;1844;-9;1835;0 - 1;0;1;2;32;29;38;AC Milan;1974;9;1983
07/02/2017;AS Roma;2094;9;2103;4 - 0;4;0;1;57;24;19;ACF Fiorentina;2001;-9;1992
05/02/2017;Juventus;2238;2;2240;1 - 0;1;0;1;73;17;10;Inter;1996;-2;1994
05/02/2017;AC Milan;1990;-16;1974;0 - 1;0;1;2;62;22;16;Sampdoria;1853;16;1869
05/02/2017;Atalanta;1947;6;1953;2 - 0;2;0;1;63;21;15;Cagliari Calcio;1802;-6;1796
05/02/2017;Genoa CFC;1863;-13;1850;0 - 1;0;1;2;48;27;25;Sassuolo Calcio;1848;13;1861
05/02/2017;Empoli FC;1792;1;1793;1 - 1;1;1;X;33;29;37;Torino FC;1912;-1;1911
05/02/2017;Chievo Verona;1861;-3;1858;0 - 0;0;0;X;49;27;24;Udinese Calcio;1839;3;1842
05/02/2017;Pescara Calcio;1675;-8;1667;2 - 6;2;6;2;17;22;61;Lazio Roma;2002;8;2010
05/02/2017;US Palermo;1737;6;1743;1 - 0;1;0;1;49;27;24;FC Crotone;1710;-6;1704
04/02/2017;Bologna FC;1856;-12;1844;1 - 7;1;7;2;21;25;53;SSC Napoli;2116;12;2128
01/02/2017;Pescara Calcio;1679;-4;1675;1 - 2;1;2;2;17;22;60;ACF Fiorentina;1997;4;2001
29/01/2017;Sassuolo Calcio;1853;-5;1848;0 - 2;0;2;2;13;19;67;Juventus;2233;5;2238
29/01/2017;Sampdoria;1838;15;1853;3 - 2;3;2;1;21;25;55;AS Roma;2108;-15;2093
29/01/2017;ACF Fiorentina;2003;-6;1997;3 - 3;3;3;X;63;21;15;Genoa CFC;1857;6;1863
29/01/2017;Torino FC;1914;-2;1912;1 - 1;1;1;X;43;29;29;Atalanta;1945;2;1947
29/01/2017;SSC Napoli;2125;-9;2116;1 - 1;1;1;X;83;12;5;US Palermo;1728;9;1737
29/01/2017;Udinese Calcio;1827;12;1839;2 - 1;2;1;1;28;28;43;AC Milan;2002;-12;1990
29/01/2017;Cagliari Calcio;1803;-1;1802;1 - 1;1;1;X;40;29;31;Bologna FC;1855;1;1856
29/01/2017;FC Crotone;1692;18;1710;4 - 1;4;1;1;33;29;37;Empoli FC;1810;-18;1792
28/01/2017;Lazio Roma;2005;-16;1989;0 - 1;0;1;2;65;21;15;Chievo Verona;1845;16;1861
28/01/2017;Inter;2006;3;2009;3 - 0;3;0;1;79;14;7;Pescara Calcio;1682;-3;1679
22/01/2017;Juventus;2226;4;2230;2 - 0;2;0;1;71;18;11;Lazio Roma;2009;-4;2005
22/01/2017;AS Roma;2106;2;2108;1 - 0;1;0;1;77;15;8;Cagliari Calcio;1805;-2;1803
22/01/2017;Atalanta;1940;5;1945;1 - 0;1;0;1;58;24;19;Sampdoria;1843;-5;1838
22/01/2017;Bologna FC;1840;15;1855;2 - 0;2;0;1;36;29;34;Torino FC;1929;-15;1914
22/01/2017;US Palermo;1734;-6;1728;0 - 1;0;1;2;21;25;54;Inter;2000;6;2006
22/01/2017;Empoli FC;1802;8;1810;1 - 0;1;0;1;42;29;29;Udinese Calcio;1835;-8;1827
22/01/2017;Genoa CFC;1864;-7;1857;2 - 2;2;2;X;67;20;13;FC Crotone;1685;7;1692
22/01/2017;Pescara Calcio;1695;-13;1682;1 - 3;1;3;2;31;29;40;Sassuolo Calcio;1840;13;1853
21/01/2017;AC Milan;2015;-10;2005;1 - 2;1;2;2;36;29;35;SSC Napoli;2110;10;2120
21/01/2017;Chievo Verona;1861;-16;1845;0 - 3;0;3;2;32;29;39;ACF Fiorentina;1992;16;2008
16/01/2017;Torino FC;1929;0;1929;2 - 2;2;2;X;37;29;34;AC Milan;2015;0;2015
15/01/2017;ACF Fiorentina;1978;14;1992;2 - 1;2;1;1;21;25;54;Juventus;2240;-14;2226
15/01/2017;Lazio Roma;1997;6;2003;2 - 1;2;1;1;52;26;22;Atalanta;1946;-6;1940
15/01/2017;Udinese Calcio;1841;-6;1835;0 - 1;0;1;2;22;25;53;AS Roma;2096;6;2102
15/01/2017;SSC Napoli;2109;1;2110;3 - 1;3;1;1;84;12;4;Pescara Calcio;1696;-1;1695
15/01/2017;Cagliari Calcio;1788;17;1805;4 - 1;4;1;1;35;29;35;Genoa CFC;1887;-17;1870
15/01/2017;Sampdoria;1851;-4;1847;0 - 0;0;0;X;52;26;22;Empoli FC;1798;4;1802
15/01/2017;Sassuolo Calcio;1849;8;1857;4 - 1;4;1;1;59;23;18;US Palermo;1742;-8;1734
14/01/2017;Inter;1989;7;1996;3 - 1;3;1;1;60;23;17;Chievo Verona;1868;-7;1861
14/01/2017;FC Crotone;1694;-9;1685;0 - 1;0;1;2;31;29;40;Bologna FC;1835;9;1844
08/01/2017;Juventus;2236;2;2238;3 - 0;3;0;1;83;12;5;Bologna FC;1837;-2;1835
08/01/2017;Genoa CFC;1894;-7;1887;0 - 1;0;1;2;26;28;46;AS Roma;2089;7;2096
08/01/2017;Udinese Calcio;1850;-9;1841;1 - 2;1;2;2;32;29;38;Inter;1980;9;1989
08/01/2017;Chievo Verona;1894;-21;1873;1 - 4;1;4;2;42;29;29;Atalanta;1927;21;1948
08/01/2017;AC Milan;2007;3;2010;1 - 0;1;0;1;70;18;11;Cagliari Calcio;1791;-3;1788
08/01/2017;Sassuolo Calcio;1849;0;1849;0 - 0;0;0;X;37;29;34;Torino FC;1934;0;1934
08/01/2017;Lazio Roma;1995;2;1997;1 - 0;1;0;1;77;15;8;FC Crotone;1696;-2;1694
07/01/2017;SSC Napoli;2106;2;2108;2 - 1;2;1;1;74;17;10;Sampdoria;1853;-2;1851
07/01/2017;Empoli FC;1792;6;1798;1 - 0;1;0;1;51;26;22;US Palermo;1748;-6;1742
22/12/2016;ACF Fiorentina;1972;1;1973;3 - 3;3;3;X;32;29;39;SSC Napoli;2107;-1;2106
22/12/2016;AS Roma;2084;5;2089;3 - 1;3;1;1;67;20;13;Chievo Verona;1899;-5;1894
22/12/2016;Torino FC;1928;6;1934;1 - 0;1;0;1;50;27;24;Genoa CFC;1900;-6;1894
22/12/2016;Sampdoria;1856;-3;1853;0 - 0;0;0;X;47;27;25;Udinese Calcio;1847;3;1850
22/12/2016;Cagliari Calcio;1782;9;1791;4 - 3;4;3;1;38;29;33;Sassuolo Calcio;1858;-9;1849
22/12/2016;US Palermo;1752;-4;1748;1 - 1;1;1;X;53;25;21;Pescara Calcio;1692;4;1696
21/12/2016;Inter;1965;15;1980;3 - 0;3;0;1;41;29;30;Lazio Roma;2010;-15;1995
20/12/2016;Atalanta;1923;4;1927;2 - 1;2;1;1;61;22;17;Empoli FC;1796;-4;1792
18/12/2016;SSC Napoli;2102;5;2107;5 - 3;5;3;1;66;20;14;Torino FC;1933;-5;1928
18/12/2016;Lazio Roma;2000;10;2010;3 - 1;3;1;1;48;27;25;ACF Fiorentina;1982;-10;1972
18/12/2016;Sassuolo Calcio;1868;-10;1858;0 - 1;0;1;2;37;29;34;Inter;1955;10;1965
18/12/2016;Chievo Verona;1893;6;1899;2 - 1;2;1;1;50;27;23;Sampdoria;1862;-6;1856
18/12/2016;Genoa CFC;1917;-17;1900;3 - 4;3;4;2;67;20;13;US Palermo;1735;17;1752
18/12/2016;Udinese Calcio;1841;6;1847;2 - 0;2;0;1;62;22;16;FC Crotone;1702;-6;1696
18/12/2016;Pescara Calcio;1709;-17;1692;0 - 3;0;3;2;34;29;36;Bologna FC;1820;17;1837
17/12/2016;Juventus;2238;4;2242;1 - 0;1;0;1;64;21;15;AS Roma;2088;-4;2084
17/12/2016;AC Milan;2006;-5;2001;0 - 0;0;0;X;57;24;19;Atalanta;1918;5;1923
17/12/2016;Empoli FC;1785;11;1796;2 - 0;2;0;1;45;28;27;Cagliari Calcio;1793;-11;1782
15/12/2016;Genoa CFC;1907;10;1917;1 - 0;1;0;1;37;29;34;ACF Fiorentina;1992;-10;1982
12/12/2016;AS Roma;2083;5;2088;1 - 0;1;0;1;55;25;20;AC Milan;2011;-5;2006
12/12/2016;ACF Fiorentina;1988;4;1992;2 - 1;2;1;1;60;23;17;Sassuolo Calcio;1872;-4;1868
11/12/2016;Torino FC;1940;-7;1933;1 - 3;1;3;2;19;24;57;Juventus;2231;7;2238
11/12/2016;Cagliari Calcio;1803;-10;1793;0 - 5;0;5;2;19;24;57;SSC Napoli;2092;10;2102
11/12/2016;Inter;1945;10;1955;2 - 0;2;0;1;50;27;24;Genoa CFC;1917;-10;1907
11/12/2016;Atalanta;1942;-24;1918;1 - 3;1;3;2;61;22;17;Udinese Calcio;1817;24;1841
11/12/2016;US Palermo;1749;-14;1735;0 - 2;0;2;2;32;29;38;Chievo Verona;1879;14;1893
11/12/2016;Bologna FC;1824;-4;1820;0 - 0;0;0;X;51;26;23;Empoli FC;1781;4;1785
10/12/2016;Sampdoria;1871;-9;1862;1 - 2;1;2;2;33;29;37;Lazio Roma;1991;9;2000
10/12/2016;FC Crotone;1694;8;1702;2 - 1;2;1;1;44;28;28;Pescara Calcio;1717;-8;1709
05/12/2016;Chievo Verona;1881;-2;1879;0 - 0;0;0;X;42;29;29;Genoa CFC;1915;2;1917
05/12/2016;Udinese Calcio;1809;8;1817;1 - 0;1;0;1;44;28;28;Bologna FC;1832;-8;1824
04/12/2016;Lazio Roma;2007;-16;1991;0 - 2;0;2;2;39;29;32;AS Roma;2075;16;2091
04/12/2016;Sampdoria;1856;15;1871;2 - 0;2;0;1;35;29;35;Torino FC;1955;-15;1940
04/12/2016;ACF Fiorentina;1977;3;1980;2 - 1;2;1;1;71;18;11;US Palermo;1752;-3;1749
04/12/2016;AC Milan;2009;2;2011;2 - 1;2;1;1;78;14;7;FC Crotone;1696;-2;1694
04/12/2016;Sassuolo Calcio;1893;8;1901;3 - 0;3;0;1;58;23;18;Empoli FC;1789;-8;1781
04/12/2016;Pescara Calcio;1717;0;1717;1 - 1;1;1;X;37;29;34;Cagliari Calcio;1803;0;1803
03/12/2016;Juventus;2225;3;2228;3 - 1;3;1;1;76;16;9;Atalanta;1945;-3;1942
02/12/2016;SSC Napoli;2063;8;2071;3 - 0;3;0;1;60;23;17;Inter;1945;-8;1937
28/11/2016;SSC Napoli;2070;-7;2063;1 - 1;1;1;X;67;20;13;Sassuolo Calcio;1886;7;1893
28/11/2016;Inter;1932;13;1945;4 - 2;4;2;1;40;29;31;ACF Fiorentina;1990;-13;1977
27/11/2016;Genoa CFC;1887;25;1912;3 - 1;3;1;1;14;20;65;Juventus;2250;-25;2225
27/11/2016;AS Roma;2074;1;2075;3 - 2;3;2;1;81;13;6;Pescara Calcio;1723;-1;1722
27/11/2016;US Palermo;1762;-6;1756;0 - 1;0;1;2;23;26;51;Lazio Roma;2001;6;2007
27/11/2016;Bologna FC;1836;-16;1820;0 - 2;0;2;2;37;29;34;Atalanta;1924;16;1940
27/11/2016;Cagliari Calcio;1807;7;1814;2 - 1;2;1;1;45;28;27;Udinese Calcio;1816;-7;1809
27/11/2016;FC Crotone;1695;1;1696;1 - 1;1;1;X;30;29;41;Sampdoria;1846;-1;1845
26/11/2016;Torino FC;1946;6;1952;2 - 1;2;1;1;54;25;21;Chievo Verona;1882;-6;1876
26/11/2016;Empoli FC;1819;-14;1805;1 - 4;1;4;2;28;28;44;AC Milan;1995;14;2009
20/11/2016;Atalanta;1912;12;1924;2 - 1;2;1;1;29;29;43;AS Roma;2081;-12;2069
20/11/2016;AC Milan;1999;-4;1995;2 - 2;2;2;X;53;26;21;Inter;1941;4;1945
20/11/2016;Lazio Roma;1994;7;2001;3 - 1;3;1;1;58;24;18;Genoa CFC;1894;-7;1887
20/11/2016;Empoli FC;1834;-15;1819;0 - 4;0;4;2;29;29;42;ACF Fiorentina;1997;15;2012
20/11/2016;Sampdoria;1837;9;1846;3 - 2;3;2;1;39;29;32;Sassuolo Calcio;1901;-9;1892
20/11/2016;FC Crotone;1705;-10;1695;0 - 2;0;2;2;24;26;50;Torino FC;1936;10;1946
20/11/2016;Bologna FC;1827;9;1836;3 - 1;3;1;1;53;26;22;US Palermo;1771;-9;1762
19/11/2016;Juventus;2230;1;2231;3 - 0;3;0;1;87;10;3;Pescara Calcio;1724;-1;1723
19/11/2016;Udinese Calcio;1822;-6;1816;1 - 2;1;2;2;22;26;52;SSC Napoli;2072;6;2078
19/11/2016;Chievo Verona;1876;6;1882;1 - 0;1;0;1;54;25;21;Cagliari Calcio;1813;-6;1807
06/11/2016;Chievo Verona;1880;-4;1876;1 - 2;1;2;2;15;21;64;Juventus;2226;4;2230
06/11/2016;AS Roma;2077;4;2081;3 - 0;3;0;1;73;17;10;Bologna FC;1831;-4;1827
06/11/2016;ACF Fiorentina;2004;-7;1997;1 - 1;1;1;X;66;20;14;Sampdoria;1830;7;1837
06/11/2016;Sassuolo Calcio;1925;-24;1901;0 - 3;0;3;2;51;26;23;Atalanta;1888;24;1912
06/11/2016;US Palermo;1778;-7;1771;1 - 2;1;2;2;25;27;48;AC Milan;1992;7;1999
06/11/2016;Genoa CFC;1899;-5;1894;1 - 1;1;1;X;56;24;20;Udinese Calcio;1817;5;1822
06/11/2016;Inter;1936;5;1941;3 - 0;3;0;1;71;18;11;FC Crotone;1710;-5;1705
06/11/2016;Pescara Calcio;1744;-20;1724;0 - 4;0;4;2;38;29;32;Empoli FC;1814;20;1834
05/11/2016;SSC Napoli;2077;-5;2072;1 - 1;1;1;X;57;24;19;Lazio Roma;1989;5;1994
05/11/2016;Torino FC;1927;9;1936;5 - 1;5;1;1;59;23;18;Cagliari Calcio;1822;-9;1813
31/10/2016;Udinese Calcio;1817;0;1817;2 - 2;2;2;X;34;29;36;Torino FC;1927;0;1927
31/10/2016;Cagliari Calcio;1816;6;1822;2 - 1;2;1;1;50;27;23;US Palermo;1784;-6;1778
30/10/2016;Lazio Roma;1983;6;1989;2 - 1;2;1;1;51;26;22;Sassuolo Calcio;1939;-6;1933
30/10/2016;Empoli FC;1810;4;1814;0 - 0;0;0;X;21;25;54;AS Roma;2072;-4;2068
30/10/2016;Atalanta;1873;15;1888;3 - 0;3;0;1;42;29;30;Genoa CFC;1914;-15;1899
30/10/2016;Sampdoria;1819;11;1830;1 - 0;1;0;1;32;29;39;Inter;1954;-11;1943
30/10/2016;AC Milan;1990;2;1992;1 - 0;1;0;1;73;17;10;Pescara Calcio;1746;-2;1744
30/10/2016;FC Crotone;1690;20;1710;2 - 0;2;0;1;25;27;48;Chievo Verona;1900;-20;1880
29/10/2016;Juventus;2235;4;2239;2 - 1;2;1;1;64;21;15;SSC Napoli;2084;-4;2080
29/10/2016;Bologna FC;1840;-9;1831;0 - 1;0;1;2;30;29;41;ACF Fiorentina;1990;9;1999
27/10/2016;US Palermo;1803;-19;1784;1 - 3;1;3;2;47;28;26;Udinese Calcio;1798;19;1817
26/10/2016;Juventus;2233;2;2235;4 - 1;4;1;1;84;12;4;Sampdoria;1821;-2;1819
26/10/2016;Sassuolo Calcio;1954;-15;1939;1 - 3;1;3;2;35;29;36;AS Roma;2057;15;2072
26/10/2016;SSC Napoli;2081;3;2084;2 - 0;2;0;1;75;16;9;Empoli FC;1813;-3;1810
26/10/2016;Inter;1947;7;1954;2 - 1;2;1;1;48;27;25;Torino FC;1934;-7;1927
26/10/2016;Lazio Roma;1976;7;1983;4 - 1;4;1;1;64;21;15;Cagliari Calcio;1823;-7;1816
26/10/2016;Chievo Verona;1904;-4;1900;1 - 1;1;1;X;54;25;21;Bologna FC;1836;4;1840
26/10/2016;ACF Fiorentina;1998;-8;1990;1 - 1;1;1;X;78;14;7;FC Crotone;1682;8;1690
26/10/2016;Pescara Calcio;1756;-10;1746;0 - 1;0;1;2;35;29;36;Atalanta;1863;10;1873
25/10/2016;Genoa CFC;1896;18;1914;3 - 0;3;0;1;34;29;37;AC Milan;2008;-18;1990
23/10/2016;Torino FC;1936;-2;1934;2 - 2;2;2;X;42;29;29;Lazio Roma;1974;2;1976
23/10/2016;AS Roma;2053;4;2057;4 - 1;4;1;1;73;17;10;US Palermo;1807;-4;1803
23/10/2016;Cagliari Calcio;1836;-13;1823;3 - 5;3;5;2;31;29;40;ACF Fiorentina;1985;13;1998
23/10/2016;Atalanta;1853;10;1863;2 - 1;2;1;1;35;29;36;Inter;1957;-10;1947
23/10/2016;Bologna FC;1835;1;1836;1 - 1;1;1;X;33;29;37;Sassuolo Calcio;1955;-1;1954
23/10/2016;FC Crotone;1685;-3;1682;1 - 2;1;2;2;13;19;69;SSC Napoli;2078;3;2081
23/10/2016;Empoli FC;1813;0;1813;0 - 0;0;0;X;36;29;34;Chievo Verona;1904;0;1904
23/10/2016;Udinese Calcio;1788;10;1798;3 - 1;3;1;1;49;27;24;Pescara Calcio;1766;-10;1756
22/10/2016;AC Milan;1994;14;2008;1 - 0;1;0;1;22;26;53;Juventus;2247;-14;2233
22/10/2016;Sampdoria;1811;10;1821;2 - 1;2;1;1;36;29;35;Genoa CFC;1906;-10;1896
17/10/2016;US Palermo;1825;-18;1807;1 - 4;1;4;2;36;29;35;Torino FC;1918;18;1936
16/10/2016;Chievo Verona;1921;-17;1904;1 - 3;1;3;2;40;29;31;AC Milan;1977;17;1994
16/10/2016;ACF Fiorentina;1979;-6;1973;0 - 0;0;0;X;62;22;16;Atalanta;1847;6;1853
16/10/2016;Lazio Roma;1980;-6;1974;1 - 1;1;1;X;64;21;15;Bologna FC;1829;6;1835
16/10/2016;Inter;1960;-16;1944;1 - 2;1;2;2;63;22;16;Cagliari Calcio;1820;16;1836
16/10/2016;Genoa CFC;1911;-5;1906;0 - 0;0;0;X;58;23;18;Empoli FC;1808;5;1813
16/10/2016;Sassuolo Calcio;1956;2;1958;2 - 1;2;1;1;75;16;9;FC Crotone;1687;-2;1685
15/10/2016;SSC Napoli;2126;-22;2104;1 - 3;1;3;2;56;24;19;AS Roma;2041;22;2063
15/10/2016;Juventus;2239;1;2240;2 - 1;2;1;1;85;11;4;Udinese Calcio;1789;-1;1788
15/10/2016;Pescara Calcio;1768;-2;1766;1 - 1;1;1;X;42;29;30;Sampdoria;1809;2;1811
02/10/2016;Empoli FC;1813;-5;1808;0 - 3;0;3;2;11;18;71;Juventus;2234;5;2239
02/10/2016;AS Roma;2036;5;2041;2 - 1;2;1;1;55;25;20;Inter;1965;-5;1960
02/10/2016;Atalanta;1832;15;1847;1 - 0;1;0;1;18;23;59;SSC Napoli;2141;-15;2126
02/10/2016;AC Milan;1970;7;1977;4 - 3;4;3;1;47;28;25;Sassuolo Calcio;1963;-7;1956
02/10/2016;Torino FC;1909;9;1918;2 - 1;2;1;1;37;29;33;ACF Fiorentina;1988;-9;1979
02/10/2016;Bologna FC;1840;-11;1829;0 - 1;0;1;2;39;29;31;Genoa CFC;1900;11;1911
02/10/2016;Sampdoria;1812;-3;1809;1 - 1;1;1;X;45;28;27;US Palermo;1822;3;1825
02/10/2016;Cagliari Calcio;1816;4;1820;2 - 1;2;1;1;61;22;17;FC Crotone;1691;-4;1687
01/10/2016;Udinese Calcio;1803;-14;1789;0 - 3;0;3;2;29;29;42;Lazio Roma;1966;14;1980
01/10/2016;Pescara Calcio;1782;-14;1768;0 - 2;0;2;2;33;29;38;Chievo Verona;1907;14;1921
26/09/2016;Cagliari Calcio;1808;8;1816;2 - 1;2;1;1;45;28;27;Sampdoria;1820;-8;1812
26/09/2016;FC Crotone;1705;-14;1691;1 - 3;1;3;2;34;29;37;Atalanta;1818;14;1832
25/09/2016;ACF Fiorentina;1985;-3;1982;0 - 0;0;0;X;48;27;25;AC Milan;1967;3;1970
25/09/2016;Torino FC;1892;17;1909;3 - 1;3;1;1;30;29;41;AS Roma;2048;-17;2031
25/09/2016;Inter;1992;-6;1986;1 - 1;1;1;X;65;21;15;Bologna FC;1834;6;1840
25/09/2016;Sassuolo Calcio;1986;3;1989;1 - 0;1;0;1;67;20;13;Udinese Calcio;1806;-3;1803
25/09/2016;Lazio Roma;1960;6;1966;2 - 0;2;0;1;63;22;16;Empoli FC;1819;-6;1813
25/09/2016;Genoa CFC;1906;-6;1900;1 - 1;1;1;X;61;22;16;Pescara Calcio;1776;6;1782
24/09/2016;US Palermo;1825;-3;1822;0 - 1;0;1;2;13;19;69;Juventus;2220;3;2223
24/09/2016;SSC Napoli;2121;4;2125;2 - 0;2;0;1;70;18;12;Chievo Verona;1911;-4;1907
21/09/2016;Juventus;2218;2;2220;4 - 0;4;0;1;84;12;4;Cagliari Calcio;1810;-2;1808
21/09/2016;Genoa CFC;1903;3;1906;0 - 0;0;0;X;24;27;49;SSC Napoli;2124;-3;2121
21/09/2016;Chievo Verona;1901;10;1911;2 - 1;2;1;1;36;29;35;Sassuolo Calcio;1996;-10;1986
21/09/2016;Empoli FC;1832;-13;1819;0 - 2;0;2;2;31;29;40;Inter;1979;13;1992
21/09/2016;Udinese Calcio;1804;2;1806;2 - 2;2;2;X;28;28;44;ACF Fiorentina;1987;-2;1985
21/09/2016;AS Roma;2045;3;2048;4 - 0;4;0;1;80;14;6;FC Crotone;1708;-3;1705
21/09/2016;Pescara Calcio;1776;0;1776;0 - 0;0;0;X;34;29;37;Torino FC;1892;0;1892
21/09/2016;Bologna FC;1823;11;1834;2 - 0;2;0;1;45;28;27;Sampdoria;1831;-11;1820
21/09/2016;Atalanta;1831;-13;1818;0 - 1;0;1;2;48;27;24;US Palermo;1812;13;1825
20/09/2016;AC Milan;1956;11;1967;2 - 0;2;0;1;44;28;27;Lazio Roma;1971;-11;1960
18/09/2016;Inter;1964;15;1979;2 - 1;2;1;1;21;25;55;Juventus;2233;-15;2218
18/09/2016;ACF Fiorentina;1978;9;1987;1 - 0;1;0;1;38;29;33;AS Roma;2054;-9;2045
18/09/2016;Sassuolo Calcio;1988;8;1996;2 - 0;2;0;1;55;25;20;Genoa CFC;1911;-8;1903
18/09/2016;Torino FC;1896;-4;1892;0 - 0;0;0;X;54;25;21;Empoli FC;1828;4;1832
18/09/2016;Udinese Calcio;1815;-11;1804;1 - 2;1;2;2;38;29;33;Chievo Verona;1890;11;1901
18/09/2016;Cagliari Calcio;1795;15;1810;3 - 0;3;0;1;40;29;31;Atalanta;1846;-15;1831
18/09/2016;FC Crotone;1708;0;1708;1 - 1;1;1;X;35;29;36;US Palermo;1812;0;1812
17/09/2016;SSC Napoli;2121;3;2124;3 - 1;3;1;1;77;15;8;Bologna FC;1826;-3;1823
17/09/2016;Lazio Roma;1965;6;1971;3 - 0;3;0;1;67;20;13;Pescara Calcio;1782;-6;1776
16/09/2016;Sampdoria;1841;-10;1831;0 - 1;0;1;2;35;29;36;AC Milan;1946;10;1956
12/09/2016;Empoli FC;1823;5;1828;2 - 1;2;1;1;59;23;18;FC Crotone;1713;-5;1708
11/09/2016;AS Roma;2055;3;2058;3 - 2;3;2;1;70;18;12;Sampdoria;1844;-3;1841
11/09/2016;Chievo Verona;1891;-1;1890;1 - 1;1;1;X;38;29;33;Lazio Roma;1964;1;1965
11/09/2016;Pescara Calcio;1789;-7;1782;1 - 2;1;2;2;26;28;46;Inter;1989;7;1996
11/09/2016;AC Milan;1962;-16;1946;0 - 1;0;1;2;65;21;14;Udinese Calcio;1799;16;1815
11/09/2016;Atalanta;1837;9;1846;2 - 1;2;1;1;39;29;32;Torino FC;1905;-9;1896
11/09/2016;Bologna FC;1819;7;1826;2 - 1;2;1;1;48;27;25;Cagliari Calcio;1802;-7;1795
10/09/2016;Juventus;2241;3;2244;3 - 1;3;1;1;75;16;9;Sassuolo Calcio;1971;-3;1968
10/09/2016;US Palermo;1821;-9;1812;0 - 3;0;3;2;20;24;55;SSC Napoli;2097;9;2106
28/08/2016;ACF Fiorentina;1977;5;1982;1 - 0;1;0;1;56;25;20;Chievo Verona;1896;-5;1891
28/08/2016;Cagliari Calcio;1798;4;1802;2 - 2;2;2;X;21;25;54;AS Roma;2059;-4;2055
28/08/2016;Inter;1996;-7;1989;1 - 1;1;1;X;67;20;13;US Palermo;1814;7;1821
28/08/2016;Sassuolo Calcio;1968;3;1971;2 - 1;2;1;1;66;20;14;Pescara Calcio;1792;-3;1789
28/08/2016;Torino FC;1894;11;1905;5 - 1;5;1;1;54;25;21;Bologna FC;1830;-11;1819
28/08/2016;Sampdoria;1837;7;1844;2 - 1;2;1;1;45;28;27;Atalanta;1844;-7;1837
28/08/2016;FC Crotone;1725;-12;1713;1 - 3;1;3;2;28;28;43;Genoa CFC;1899;12;1911
28/08/2016;Udinese Calcio;1786;13;1799;2 - 0;2;0;1;41;29;30;Empoli FC;1836;-13;1823
27/08/2016;Lazio Roma;1970;-6;1964;0 - 1;0;1;2;21;25;54;Juventus;2235;6;2241
27/08/2016;SSC Napoli;2090;7;2097;4 - 2;4;2;1;60;23;17;AC Milan;1969;-7;1962
21/08/2016;Chievo Verona;1880;16;1896;2 - 0;2;0;1;32;29;39;Inter;2012;-16;1996
21/08/2016;Pescara Calcio;1787;5;1792;2 - 2;2;2;X;18;23;59;SSC Napoli;2095;-5;2090
21/08/2016;AC Milan;1963;6;1969;3 - 2;3;2;1;54;25;21;Torino FC;1900;-6;1894
21/08/2016;Atalanta;1854;-10;1844;3 - 4;3;4;2;35;29;36;Lazio Roma;1960;10;1970
21/08/2016;US Palermo;1823;-9;1814;0 - 1;0;1;2;31;29;40;Sassuolo Calcio;1963;9;1972
21/08/2016;Genoa CFC;1891;8;1899;3 - 1;3;1;1;56;24;19;Cagliari Calcio;1806;-8;1798
21/08/2016;Empoli FC;1850;-14;1836;0 - 1;0;1;2;49;27;24;Sampdoria;1823;14;1837
21/08/2016;Bologna FC;1825;5;1830;1 - 0;1;0;1;57;24;19;FC Crotone;1730;-5;1725
20/08/2016;Juventus;2233;2;2235;2 - 1;2;1;1;74;17;10;ACF Fiorentina;1979;-2;1977
20/08/2016;AS Roma;2091;3;2094;4 - 0;4;0;1;78;15;8;Udinese Calcio;1789;-3;1786
15/05/2016;Lazio Roma;1980;-20;1960;2 - 4;2;4;2;49;27;24;ACF Fiorentina;1959;20;1979
15/05/2016;Empoli FC;1837;9;1846;2 - 1;2;1;1;39;29;32;Torino FC;1906;-9;1897
15/05/2016;Genoa CFC;1901;-14;1887;1 - 2;1;2;2;54;25;21;Atalanta;1837;14;1851
15/05/2016;Chievo Verona;1879;-4;1875;0 - 0;0;0;X;54;25;21;Bologna FC;1812;4;1816
15/05/2016;Udinese Calcio;1817;-13;1804;1 - 2;1;2;2;48;27;25;Carpi FC;1806;13;1819
15/05/2016;US Palermo;1812;7;1819;3 - 2;3;2;1;49;27;24;Hellas Verona;1790;-7;1783
14/05/2016;AC Milan;1982;-15;1967;1 - 3;1;3;2;36;29;35;AS Roma;2077;15;2092
14/05/2016;Juventus;2227;2;2229;5 - 0;5;0;1;83;12;5;Sampdoria;1825;-2;1823
14/05/2016;Sassuolo Calcio;1935;15;1950;3 - 1;3;1;1;36;29;34;Inter;2027;-15;2012
14/05/2016;SSC Napoli;2093;2;2095;4 - 0;4;0;1;82;13;5;Frosinone Calcio;1713;-2;1711
08/05/2016;Hellas Verona;1772;18;1790;2 - 1;2;1;1;9;15;76;Juventus;2245;-18;2227
08/05/2016;Torino FC;1914;-8;1906;1 - 2;1;2;2;29;28;43;SSC Napoli;2085;8;2093
08/05/2016;AS Roma;2071;6;2077;3 - 0;3;0;1;67;20;13;Chievo Verona;1885;-6;1879
08/05/2016;Carpi FC;1819;-13;1806;1 - 3;1;3;2;31;29;40;Lazio Roma;1967;13;1980
08/05/2016;ACF Fiorentina;1965;-6;1959;0 - 0;0;0;X;65;21;15;US Palermo;1806;6;1812
08/05/2016;Sampdoria;1846;-21;1825;0 - 3;0;3;2;42;29;29;Genoa CFC;1880;21;1901
08/05/2016;Atalanta;1841;-4;1837;1 - 1;1;1;X;50;27;24;Udinese Calcio;1813;4;1817
08/05/2016;Frosinone Calcio;1720;-7;1713;0 - 1;0;1;2;25;27;47;Sassuolo Calcio;1928;7;1935
07/05/2016;Inter;2024;3;2027;2 - 1;2;1;1;67;20;13;Empoli FC;1840;-3;1837
07/05/2016;Bologna FC;1820;-8;1812;0 - 1;0;1;2;30;29;41;AC Milan;1974;8;1982
02/05/2016;Genoa CFC;1888;-8;1880;2 - 3;2;3;2;28;28;43;AS Roma;2063;8;2071
02/05/2016;SSC Napoli;2083;2;2085;2 - 1;2;1;1;73;17;10;Atalanta;1843;-2;1841
01/05/2016;Juventus;2244;1;2245;2 - 0;2;0;1;84;12;4;Carpi FC;1820;-1;1819
01/05/2016;Lazio Roma;1953;14;1967;2 - 0;2;0;1;37;29;34;Inter;2038;-14;2024
01/05/2016;Sassuolo Calcio;1924;4;1928;1 - 0;1;0;1;63;21;15;Hellas Verona;1776;-4;1772
01/05/2016;AC Milan;1982;-8;1974;3 - 3;3;3;X;75;16;9;Frosinone Calcio;1712;8;1720
01/05/2016;Empoli FC;1844;-4;1840;0 - 0;0;0;X;50;27;24;Bologna FC;1816;4;1820
01/05/2016;US Palermo;1792;14;1806;2 - 0;2;0;1;39;29;32;Sampdoria;1860;-14;1846
30/04/2016;Chievo Verona;1886;-1;1885;0 - 0;0;0;X;38;29;33;ACF Fiorentina;1964;1;1965
30/04/2016;Udinese Calcio;1834;-21;1813;1 - 5;1;5;2;40;29;31;Torino FC;1893;21;1914
25/04/2016;AS Roma;2055;8;2063;1 - 0;1;0;1;42;29;29;SSC Napoli;2091;-8;2083
25/04/2016;Hellas Verona;1762;14;1776;2 - 1;2;1;1;23;26;50;AC Milan;1996;-14;1982
25/04/2016;Carpi FC;1812;8;1820;1 - 0;1;0;1;42;29;30;Empoli FC;1852;-8;1844
24/04/2016;ACF Fiorentina;1969;-5;1964;1 - 2;1;2;2;21;25;55;Juventus;2239;5;2244
24/04/2016;Torino FC;1913;-20;1893;1 - 3;1;3;2;47;27;25;Sassuolo Calcio;1904;20;1924
24/04/2016;Sampdoria;1850;10;1860;2 - 1;2;1;1;34;29;37;Lazio Roma;1963;-10;1953
24/04/2016;Atalanta;1834;9;1843;1 - 0;1;0;1;39;29;31;Chievo Verona;1895;-9;1886
24/04/2016;Bologna FC;1801;15;1816;2 - 0;2;0;1;35;29;35;Genoa CFC;1903;-15;1888
24/04/2016;Frosinone Calcio;1729;-17;1712;0 - 2;0;2;2;41;29;30;US Palermo;1775;17;1792
23/04/2016;Inter;2033;5;2038;3 - 1;3;1;1;68;19;13;Udinese Calcio;1839;-5;1834
21/04/2016;AC Milan;2003;-7;1996;0 - 0;0;0;X;69;19;12;Carpi FC;1805;7;1812
20/04/2016;Juventus;2235;4;2239;3 - 0;3;0;1;75;16;9;Lazio Roma;1967;-4;1963
20/04/2016;AS Roma;2051;4;2055;3 - 2;3;2;1;62;22;16;Torino FC;1917;-4;1913
20/04/2016;Genoa CFC;1891;12;1903;1 - 0;1;0;1;30;29;41;Inter;2045;-12;2033
20/04/2016;Udinese Calcio;1827;12;1839;2 - 1;2;1;1;30;29;41;ACF Fiorentina;1981;-12;1969
20/04/2016;Sassuolo Calcio;1908;-4;1904;0 - 0;0;0;X;54;25;21;Sampdoria;1846;4;1850
20/04/2016;Chievo Verona;1888;7;1895;5 - 1;5;1;1;64;21;15;Frosinone Calcio;1736;-7;1729
20/04/2016;Empoli FC;1847;5;1852;1 - 0;1;0;1;56;25;20;Hellas Verona;1767;-5;1762
20/04/2016;US Palermo;1776;-1;1775;2 - 2;2;2;X;40;29;31;Atalanta;1833;1;1834
19/04/2016;SSC Napoli;2087;4;2091;6 - 0;6;0;1;76;16;8;Bologna FC;1805;-4;1801
17/04/2016;Juventus;2234;1;2235;4 - 0;4;0;1;86;11;3;US Palermo;1777;-1;1776
17/04/2016;ACF Fiorentina;1972;9;1981;3 - 1;3;1;1;53;26;22;Sassuolo Calcio;1917;-9;1908
17/04/2016;Atalanta;1830;3;1833;3 - 3;3;3;X;24;27;49;AS Roma;2054;-3;2051
17/04/2016;Sampdoria;1855;-9;1846;0 - 1;0;1;2;31;29;39;AC Milan;1994;9;2003
17/04/2016;Lazio Roma;1960;7;1967;2 - 0;2;0;1;59;23;18;Empoli FC;1854;-7;1847
17/04/2016;Udinese Calcio;1828;-1;1827;0 - 0;0;0;X;40;29;31;Chievo Verona;1887;1;1888
17/04/2016;Hellas Verona;1781;-14;1767;1 - 2;1;2;2;53;25;21;Frosinone Calcio;1722;14;1736
16/04/2016;Inter;2031;14;2045;2 - 0;2;0;1;38;29;32;SSC Napoli;2101;-14;2087
16/04/2016;Bologna FC;1815;-10;1805;0 - 1;0;1;2;36;29;34;Torino FC;1907;10;1917
16/04/2016;Carpi FC;1786;19;1805;4 - 1;4;1;1;33;29;38;Genoa CFC;1910;-19;1891
11/04/2016;AS Roma;2062;-8;2054;1 - 1;1;1;X;74;17;10;Bologna FC;1807;8;1815
10/04/2016;SSC Napoli;2098;3;2101;3 - 0;3;0;1;78;14;7;Hellas Verona;1784;-3;1781
10/04/2016;Empoli FC;1837;17;1854;2 - 0;2;0;1;30;29;41;ACF Fiorentina;1989;-17;1972
10/04/2016;Torino FC;1901;6;1907;2 - 1;2;1;1;54;25;21;Atalanta;1836;-6;1830
10/04/2016;US Palermo;1792;-15;1777;0 - 3;0;3;2;30;29;41;Lazio Roma;1945;15;1960
10/04/2016;Sampdoria;1844;11;1855;2 - 0;2;0;1;47;28;26;Udinese Calcio;1839;-11;1828
09/04/2016;AC Milan;2001;-7;1994;1 - 2;1;2;2;24;27;49;Juventus;2227;7;2234
09/04/2016;Sassuolo Calcio;1931;-14;1917;0 - 1;0;1;2;50;27;23;Genoa CFC;1896;14;1910
09/04/2016;Frosinone Calcio;1727;-5;1722;0 - 1;0;1;2;18;23;58;Inter;2026;5;2031
09/04/2016;Chievo Verona;1882;5;1887;1 - 0;1;0;1;57;24;19;Carpi FC;1791;-5;1786
04/04/2016;Bologna FC;1821;-14;1807;0 - 1;0;1;2;52;26;22;Hellas Verona;1770;14;1784
03/04/2016;Lazio Roma;1963;-18;1945;1 - 4;1;4;2;37;29;33;AS Roma;2044;18;2062
03/04/2016;Udinese Calcio;1816;23;1839;3 - 1;3;1;1;18;23;59;SSC Napoli;2121;-23;2098
03/04/2016;Inter;2042;-16;2026;1 - 2;1;2;2;64;21;15;Torino FC;1885;16;1901
03/04/2016;Atalanta;1823;13;1836;2 - 1;2;1;1;27;28;45;AC Milan;2014;-13;2001
03/04/2016;ACF Fiorentina;1995;-6;1989;1 - 1;1;1;X;64;21;15;Sampdoria;1838;6;1844
03/04/2016;Chievo Verona;1874;8;1882;3 - 1;3;1;1;55;25;20;US Palermo;1800;-8;1792
03/04/2016;Genoa CFC;1889;7;1896;4 - 0;4;0;1;64;21;15;Frosinone Calcio;1734;-7;1727
02/04/2016;Juventus;2226;1;2227;1 - 0;1;0;1;83;12;5;Empoli FC;1838;-1;1837
02/04/2016;Carpi FC;1805;-14;1791;1 - 3;1;3;2;34;29;37;Sassuolo Calcio;1917;14;1931
20/03/2016;Torino FC;1892;-7;1885;1 - 4;1;4;2;17;22;61;Juventus;2219;7;2226
20/03/2016;SSC Napoli;2117;4;2121;3 - 1;3;1;1;71;18;11;Genoa CFC;1893;-4;1889
20/03/2016;AC Milan;2018;-4;2014;1 - 1;1;1;X;53;25;21;Lazio Roma;1959;4;1963
20/03/2016;Sassuolo Calcio;1922;-5;1917;1 - 1;1;1;X;59;23;18;Udinese Calcio;1811;5;1816
20/03/2016;Frosinone Calcio;1729;5;1734;0 - 0;0;0;X;20;25;55;ACF Fiorentina;2000;-5;1995
20/03/2016;Sampdoria;1851;-13;1838;0 - 1;0;1;2;45;28;27;Chievo Verona;1861;13;1874
20/03/2016;Atalanta;1811;12;1823;2 - 0;2;0;1;44;28;28;Bologna FC;1833;-12;1821
20/03/2016;Hellas Verona;1783;-13;1770;1 - 2;1;2;2;45;28;27;Carpi FC;1792;13;1805
19/03/2016;AS Roma;2047;-3;2044;1 - 1;1;1;X;47;28;25;Inter;2039;3;2042
19/03/2016;Empoli FC;1842;-4;1838;0 - 0;0;0;X;52;26;22;US Palermo;1796;4;1800
13/03/2016;US Palermo;1801;-5;1796;0 - 1;0;1;2;18;23;60;SSC Napoli;2112;5;2117
13/03/2016;Chievo Verona;1859;2;1861;0 - 0;0;0;X;29;29;42;AC Milan;2020;-2;2018
13/03/2016;Udinese Calcio;1818;-7;1811;1 - 2;1;2;2;24;27;49;AS Roma;2040;7;2047
13/03/2016;Lazio Roma;1984;5;1989;2 - 0;2;0;1;66;20;14;Atalanta;1816;-5;1811
13/03/2016;Genoa CFC;1885;8;1893;3 - 2;3;2;1;44;28;27;Torino FC;1900;-8;1892
13/03/2016;ACF Fiorentina;2007;-7;2000;1 - 1;1;1;X;72;18;11;Hellas Verona;1776;7;1783
13/03/2016;Carpi FC;1786;6;1792;2 - 1;2;1;1;52;26;22;Frosinone Calcio;1735;-6;1729
12/03/2016;Inter;2036;3;2039;2 - 1;2;1;1;69;19;12;Bologna FC;1836;-3;1833
12/03/2016;Empoli FC;1845;-3;1842;1 - 1;1;1;X;46;28;26;Sampdoria;1848;3;1851
11/03/2016;Juventus;2231;2;2233;1 - 0;1;0;1;78;15;7;Sassuolo Calcio;1924;-2;1922
06/03/2016;Atalanta;1820;-4;1816;0 - 2;0;2;2;12;18;70;Juventus;2227;4;2231
06/03/2016;Sassuolo Calcio;1908;16;1924;2 - 0;2;0;1;33;29;38;AC Milan;2036;-16;2020
06/03/2016;Torino FC;1901;-1;1900;1 - 1;1;1;X;37;29;33;Lazio Roma;1980;1;1981
06/03/2016;Inter;2032;4;2036;3 - 1;3;1;1;71;18;11;US Palermo;1805;-4;1801
06/03/2016;Genoa CFC;1879;6;1885;1 - 0;1;0;1;50;27;24;Empoli FC;1851;-6;1845
06/03/2016;Bologna FC;1840;-4;1836;0 - 0;0;0;X;53;26;21;Carpi FC;1782;4;1786
06/03/2016;Frosinone Calcio;1719;16;1735;2 - 0;2;0;1;34;29;37;Udinese Calcio;1834;-16;1818
05/03/2016;SSC Napoli;2108;4;2112;3 - 1;3;1;1;73;17;10;Chievo Verona;1863;-4;1859
05/03/2016;Hellas Verona;1797;-21;1776;0 - 3;0;3;2;43;29;29;Sampdoria;1827;21;1848
04/03/2016;AS Roma;2034;12;2046;4 - 1;4;1;1;48;27;25;ACF Fiorentina;2019;-12;2007
29/02/2016;ACF Fiorentina;2019;0;2019;1 - 1;1;1;X;36;29;34;SSC Napoli;2108;0;2108
29/02/2016;Lazio Roma;2003;-23;1980;0 - 2;0;2;2;60;23;17;Sassuolo Calcio;1885;23;1908
28/02/2016;Juventus;2247;4;2251;2 - 0;2;0;1;72;17;10;Inter;2012;-4;2008
28/02/2016;Chievo Verona;1855;8;1863;1 - 0;1;0;1;43;29;29;Genoa CFC;1887;-8;1879
28/02/2016;US Palermo;1807;-2;1805;0 - 0;0;0;X;43;29;29;Bologna FC;1838;2;1840
28/02/2016;Udinese Calcio;1824;10;1834;2 - 0;2;0;1;48;27;25;Hellas Verona;1807;-10;1797
28/02/2016;Carpi FC;1784;-2;1782;1 - 1;1;1;X;42;29;29;Atalanta;1818;2;1820
28/02/2016;Sampdoria;1820;7;1827;2 - 0;2;0;1;57;24;19;Frosinone Calcio;1726;-7;1719
27/02/2016;AC Milan;2027;4;2031;1 - 0;1;0;1;61;23;17;Torino FC;1905;-4;1901
27/02/2016;Empoli FC;1863;-12;1851;1 - 3;1;3;2;30;29;42;AS Roma;2022;12;2034
22/02/2016;SSC Napoli;2119;-5;2114;1 - 1;1;1;X;58;24;19;AC Milan;2022;5;2027
21/02/2016;Atalanta;1825;-7;1818;2 - 3;2;3;2;26;28;46;ACF Fiorentina;2024;7;2031
21/02/2016;AS Roma;2016;6;2022;5 - 0;5;0;1;69;19;12;US Palermo;1813;-6;1807
21/02/2016;Sassuolo Calcio;1878;7;1885;3 - 2;3;2;1;47;28;25;Empoli FC;1870;-7;1863
21/02/2016;Frosinone Calcio;1721;5;1726;0 - 0;0;0;X;20;24;56;Lazio Roma;2000;-5;1995
21/02/2016;Genoa CFC;1881;6;1887;2 - 1;2;1;1;52;26;22;Udinese Calcio;1830;-6;1824
21/02/2016;Torino FC;1911;-6;1905;0 - 0;0;0;X;62;22;16;Carpi FC;1778;6;1784
20/02/2016;Inter;2007;5;2012;3 - 1;3;1;1;67;20;13;Sampdoria;1825;-5;1820
20/02/2016;Hellas Verona;1793;14;1807;3 - 1;3;1;1;38;29;33;Chievo Verona;1869;-14;1855
19/02/2016;Bologna FC;1831;7;1838;0 - 0;0;0;X;11;17;72;Juventus;2257;-7;2250
14/02/2016;ACF Fiorentina;2017;7;2024;2 - 1;2;1;1;47;28;26;Inter;2014;-7;2007
14/02/2016;AC Milan;2018;4;2022;2 - 1;2;1;1;62;22;16;Genoa CFC;1885;-4;1881
14/02/2016;US Palermo;1829;-16;1813;1 - 3;1;3;2;39;29;32;Torino FC;1895;16;1911
14/02/2016;Udinese Calcio;1844;-14;1830;0 - 1;0;1;2;49;27;24;Bologna FC;1817;14;1831
14/02/2016;Sampdoria;1828;-3;1825;0 - 0;0;0;X;47;28;25;Atalanta;1822;3;1825
13/02/2016;Juventus;2253;4;2257;1 - 0;1;0;1;60;23;17;SSC Napoli;2137;-4;2133
13/02/2016;Chievo Verona;1872;-3;1869;1 - 1;1;1;X;46;28;26;Sassuolo Calcio;1875;3;1878
13/02/2016;Empoli FC;1887;-17;1870;1 - 2;1;2;2;67;20;13;Frosinone Calcio;1704;17;1721
12/02/2016;Carpi FC;1788;-10;1778;1 - 3;1;3;2;24;26;50;AS Roma;2019;10;2029
11/02/2016;Lazio Roma;1997;5;2002;5 - 2;5;2;1;69;19;12;Hellas Verona;1798;-5;1793
07/02/2016;Frosinone Calcio;1706;-2;1704;0 - 2;0;2;2;6;13;81;Juventus;2251;2;2253
07/02/2016;SSC Napoli;2136;1;2137;1 - 0;1;0;1;80;13;6;Carpi FC;1789;-1;1788
07/02/2016;AC Milan;2025;-7;2018;1 - 1;1;1;X;68;19;13;Udinese Calcio;1837;7;1844
07/02/2016;AS Roma;2016;3;2019;2 - 1;2;1;1;67;20;13;Sampdoria;1831;-3;1828
07/02/2016;Hellas Verona;1795;3;1798;3 - 3;3;3;X;24;27;49;Inter;2017;-3;2014
07/02/2016;Torino FC;1909;-14;1895;1 - 2;1;2;2;52;26;22;Chievo Verona;1858;14;1872
07/02/2016;Atalanta;1823;-1;1822;0 - 0;0;0;X;39;29;32;Empoli FC;1886;1;1887
07/02/2016;Sassuolo Calcio;1879;-4;1875;2 - 2;2;2;X;53;26;22;US Palermo;1825;4;1829
06/02/2016;Genoa CFC;1885;0;1885;0 - 0;0;0;X;34;29;37;Lazio Roma;1997;0;1997
06/02/2016;Bologna FC;1814;3;1817;1 - 1;1;1;X;26;27;47;ACF Fiorentina;2020;-3;2017
03/02/2016;Juventus;2250;1;2251;1 - 0;1;0;1;81;13;6;Genoa CFC;1886;-1;1885
03/02/2016;Lazio Roma;2012;-15;1997;0 - 2;0;2;2;34;29;36;SSC Napoli;2121;15;2136
03/02/2016;Inter;2013;4;2017;1 - 0;1;0;1;64;21;15;Chievo Verona;1862;-4;1858
03/02/2016;US Palermo;1837;-12;1825;0 - 2;0;2;2;28;28;44;AC Milan;2013;12;2025
03/02/2016;ACF Fiorentina;2017;3;2020;2 - 1;2;1;1;71;18;11;Carpi FC;1792;-3;1789
03/02/2016;Sampdoria;1832;-1;1831;2 - 2;2;2;X;38;29;33;Torino FC;1908;1;1909
03/02/2016;Empoli FC;1890;-4;1886;1 - 1;1;1;X;53;26;21;Udinese Calcio;1833;4;1837
03/02/2016;Hellas Verona;1787;8;1795;2 - 1;2;1;1;41;29;30;Atalanta;1831;-8;1823
03/02/2016;Frosinone Calcio;1695;11;1706;1 - 0;1;0;1;32;29;38;Bologna FC;1825;-11;1814
02/02/2016;Sassuolo Calcio;1894;-15;1879;0 - 2;0;2;2;35;29;36;AS Roma;2001;15;2016
31/01/2016;Chievo Verona;1868;-6;1862;0 - 4;0;4;2;14;20;67;Juventus;2244;6;2250
31/01/2016;AC Milan;1999;14;2013;3 - 0;3;0;1;43;29;28;Inter;2027;-14;2013
31/01/2016;SSC Napoli;2116;5;2121;5 - 1;5;1;1;71;18;11;Empoli FC;1895;-5;1890
31/01/2016;Genoa CFC;1885;1;1886;0 - 0;0;0;X;32;29;39;ACF Fiorentina;2018;-1;2017
31/01/2016;Udinese Calcio;1831;2;1833;0 - 0;0;0;X;28;28;44;Lazio Roma;2014;-2;2012
31/01/2016;Torino FC;1914;-6;1908;0 - 0;0;0;X;62;22;16;Hellas Verona;1781;6;1787
31/01/2016;Bologna FC;1817;8;1825;3 - 2;3;2;1;44;28;28;Sampdoria;1840;-8;1832
30/01/2016;Atalanta;1832;-1;1831;1 - 1;1;1;X;39;29;31;Sassuolo Calcio;1893;1;1894
30/01/2016;AS Roma;1998;3;2001;3 - 1;3;1;1;77;15;8;Frosinone Calcio;1698;-3;1695
30/01/2016;Carpi FC;1794;-2;1792;1 - 1;1;1;X;42;29;30;US Palermo;1835;2;1837
24/01/2016;Juventus;2236;3;2239;1 - 0;1;0;1;72;17;10;AS Roma;2001;-3;1998
24/01/2016;Sampdoria;1849;-9;1840;2 - 4;2;4;2;21;25;53;SSC Napoli;2107;9;2116
24/01/2016;ACF Fiorentina;2010;8;2018;2 - 0;2;0;1;57;24;19;Torino FC;1922;-8;1914
24/01/2016;Lazio Roma;2007;7;2014;4 - 1;4;1;1;62;22;16;Chievo Verona;1875;-7;1868
24/01/2016;Inter;2040;-8;2032;1 - 1;1;1;X;74;17;10;Carpi FC;1786;8;1794
24/01/2016;Sassuolo Calcio;1916;-23;1893;0 - 2;0;2;2;61;23;17;Bologna FC;1794;23;1817
24/01/2016;Hellas Verona;1781;0;1781;1 - 1;1;1;X;35;29;36;Genoa CFC;1885;0;1885
24/01/2016;US Palermo;1821;14;1835;4 - 1;4;1;1;43;28;28;Udinese Calcio;1845;-14;1831
23/01/2016;Empoli FC;1895;0;1895;2 - 2;2;2;X;36;29;35;AC Milan;1991;0;1991
23/01/2016;Frosinone Calcio;1697;1;1698;0 - 0;0;0;X;32;29;39;Atalanta;1833;-1;1832
20/01/2016;Sassuolo Calcio;1919;-3;1916;1 - 1;1;1;X;46;28;26;Torino FC;1919;3;1922
17/01/2016;Udinese Calcio;1852;-7;1845;0 - 4;0;4;2;14;20;66;Juventus;2222;7;2229
17/01/2016;AC Milan;1978;13;1991;2 - 0;2;0;1;41;29;30;ACF Fiorentina;2023;-13;2010
17/01/2016;Bologna FC;1790;4;1794;2 - 2;2;2;X;24;27;50;Lazio Roma;2018;-4;2014
17/01/2016;AS Roma;2008;-7;2001;1 - 1;1;1;X;72;17;11;Hellas Verona;1774;7;1781
17/01/2016;Chievo Verona;1877;-2;1875;1 - 1;1;1;X;44;28;27;Empoli FC;1893;2;1895
17/01/2016;Genoa CFC;1874;11;1885;4 - 0;4;0;1;51;26;23;US Palermo;1832;-11;1821
17/01/2016;Carpi FC;1777;9;1786;2 - 1;2;1;1;37;29;33;Sampdoria;1858;-9;1849
16/01/2016;SSC Napoli;2126;4;2130;3 - 1;3;1;1;69;19;12;Sassuolo Calcio;1923;-4;1919
16/01/2016;Atalanta;1831;2;1833;1 - 1;1;1;X;27;28;45;Inter;2019;-2;2017
16/01/2016;Torino FC;1915;4;1919;4 - 2;4;2;1;70;18;12;Frosinone Calcio;1701;-4;1697
10/01/2016;Sampdoria;1862;-4;1858;1 - 2;1;2;2;15;21;65;Juventus;2218;4;2222
10/01/2016;Inter;2035;-16;2019;0 - 1;0;1;2;61;22;16;Sassuolo Calcio;1907;16;1923
10/01/2016;Frosinone Calcio;1706;-5;1701;1 - 5;1;5;2;12;18;71;SSC Napoli;2121;5;2126
10/01/2016;Torino FC;1929;-14;1915;0 - 1;0;1;2;52;26;22;Empoli FC;1879;14;1893
10/01/2016;Atalanta;1850;-19;1831;0 - 2;0;2;2;46;28;26;Genoa CFC;1855;19;1874
10/01/2016;Bologna FC;1801;-11;1790;0 - 1;0;1;2;39;29;32;Chievo Verona;1866;11;1877
10/01/2016;Hellas Verona;1786;-12;1774;0 - 1;0;1;2;42;29;29;US Palermo;1820;12;1832
09/01/2016;ACF Fiorentina;2044;-21;2023;1 - 3;1;3;2;52;26;22;Lazio Roma;1997;21;2018
09/01/2016;AS Roma;2012;-4;2008;1 - 1;1;1;X;51;26;23;AC Milan;1971;4;1975
09/01/2016;Carpi FC;1770;10;1780;2 - 1;2;1;1;36;29;34;Udinese Calcio;1862;-10;1852
06/01/2016;SSC Napoli;2118;3;2121;2 - 1;2;1;1;67;20;13;Torino FC;1932;-3;1929
06/01/2016;Juventus;2216;2;2218;3 - 0;3;0;1;84;11;4;Hellas Verona;1788;-2;1786
06/01/2016;Empoli FC;1888;-9;1879;0 - 1;0;1;2;32;29;39;Inter;2026;9;2035
06/01/2016;Chievo Verona;1865;1;1866;3 - 3;3;3;X;31;29;40;AS Roma;2013;-1;2012
06/01/2016;US Palermo;1831;-11;1820;1 - 3;1;3;2;26;28;47;ACF Fiorentina;2033;11;2044
06/01/2016;AC Milan;1988;-17;1971;0 - 1;0;1;2;69;19;12;Bologna FC;1784;17;1801
06/01/2016;Lazio Roma;2005;-8;1997;0 - 0;0;0;X;73;17;10;Carpi FC;1762;8;1770
06/01/2016;Udinese Calcio;1855;7;1862;2 - 1;2;1;1;46;28;26;Atalanta;1857;-7;1850
06/01/2016;Sassuolo Calcio;1914;-7;1907;2 - 2;2;2;X;70;18;11;Frosinone Calcio;1699;7;1706
05/01/2016;Genoa CFC;1868;-13;1855;2 - 3;2;3;2;48;27;24;Sampdoria;1849;13;1862
20/12/2015;Inter;2040;-14;2026;1 - 2;1;2;2;52;26;22;Lazio Roma;1991;14;2005
20/12/2015;Carpi FC;1764;-2;1762;2 - 3;2;3;2;10;16;74;Juventus;2214;2;2216
20/12/2015;Atalanta;1866;-9;1857;1 - 3;1;3;2;23;26;51;SSC Napoli;2109;9;2118
20/12/2015;ACF Fiorentina;2027;6;2033;2 - 0;2;0;1;64;21;15;Chievo Verona;1871;-6;1865
20/12/2015;AS Roma;2007;6;2013;2 - 0;2;0;1;62;22;16;Genoa CFC;1874;-6;1868
20/12/2015;Torino FC;1947;-15;1932;0 - 1;0;1;2;59;23;18;Udinese Calcio;1840;15;1855
20/12/2015;Hellas Verona;1787;1;1788;1 - 1;1;1;X;33;29;38;Sassuolo Calcio;1915;-1;1914
20/12/2015;Frosinone Calcio;1707;-8;1699;2 - 4;2;4;2;20;25;55;AC Milan;1980;8;1988
20/12/2015;Sampdoria;1838;11;1849;2 - 0;2;0;1;46;28;26;US Palermo;1842;-11;1831
19/12/2015;Bologna FC;1795;-11;1784;2 - 3;2;3;2;37;29;33;Empoli FC;1877;11;1888
14/12/2015;Lazio Roma;1993;-6;1987;1 - 1;1;1;X;63;21;15;Sampdoria;1846;6;1852
13/12/2015;Juventus;2204;6;2210;3 - 1;3;1;1;64;21;15;ACF Fiorentina;2051;-6;2045
13/12/2015;SSC Napoli;2111;-5;2106;0 - 0;0;0;X;58;24;18;AS Roma;2010;5;2015
13/12/2015;AC Milan;1973;-7;1966;1 - 1;1;1;X;68;19;13;Hellas Verona;1783;7;1790
13/12/2015;Chievo Verona;1864;7;1871;1 - 0;1;0;1;45;28;27;Atalanta;1873;-7;1866
13/12/2015;Empoli FC;1869;8;1877;3 - 0;3;0;1;60;23;17;Carpi FC;1754;-8;1746
12/12/2015;Udinese Calcio;1860;-16;1844;0 - 4;0;4;2;30;29;42;Inter;2019;16;2035
12/12/2015;Genoa CFC;1905;-16;1889;0 - 1;0;1;2;61;22;17;Bologna FC;1779;16;1795
12/12/2015;US Palermo;1834;8;1842;4 - 1;4;1;1;60;23;17;Frosinone Calcio;1715;-8;1707
06/12/2015;ACF Fiorentina;2043;6;2049;3 - 0;3;0;1;67;20;14;Udinese Calcio;1866;-6;1860
06/12/2015;Bologna FC;1763;16;1779;3 - 2;3;2;1;15;20;65;SSC Napoli;2123;-16;2107
06/12/2015;Sampdoria;1864;-18;1846;1 - 3;1;3;2;42;29;29;Sassuolo Calcio;1897;18;1915
06/12/2015;Carpi FC;1750;4;1754;0 - 0;0;0;X;24;27;50;AC Milan;1977;-4;1973
06/12/2015;Atalanta;1861;12;1873;3 - 0;3;0;1;48;27;25;US Palermo;1846;-12;1834
06/12/2015;Hellas Verona;1794;-11;1783;0 - 1;0;1;2;39;29;32;Empoli FC;1858;11;1869
06/12/2015;Frosinone Calcio;1729;-14;1715;0 - 2;0;2;2;33;29;37;Chievo Verona;1850;14;1864
05/12/2015;Torino FC;1952;-1;1951;1 - 1;1;1;X;39;29;32;AS Roma;2020;1;2021
05/12/2015;Inter;2014;5;2019;1 - 0;1;0;1;58;23;18;Genoa CFC;1910;-5;1905
04/12/2015;Lazio Roma;2002;-10;1992;0 - 2;0;2;2;25;27;48;Juventus;2213;10;2223
30/11/2015;SSC Napoli;2118;5;2123;2 - 1;2;1;1;58;24;18;Inter;2019;-5;2014
30/11/2015;Sassuolo Calcio;1911;1;1912;1 - 1;1;1;X;32;29;39;ACF Fiorentina;2044;-1;2043
29/11/2015;US Palermo;1868;-7;1861;0 - 3;0;3;2;16;21;63;Juventus;2206;7;2213
29/11/2015;AS Roma;2045;-25;2020;0 - 2;0;2;2;69;19;12;Atalanta;1847;25;1872
29/11/2015;Empoli FC;1846;12;1858;1 - 0;1;0;1;29;29;43;Lazio Roma;2014;-12;2002
29/11/2015;Chievo Verona;1863;-13;1850;2 - 3;2;3;2;49;27;24;Udinese Calcio;1842;13;1855
29/11/2015;Genoa CFC;1927;-17;1910;1 - 2;1;2;2;69;19;12;Carpi FC;1728;17;1745
29/11/2015;Frosinone Calcio;1719;10;1729;3 - 2;3;2;1;37;29;34;Hellas Verona;1804;-10;1794
28/11/2015;AC Milan;1965;9;1974;4 - 1;4;1;1;57;24;19;Sampdoria;1873;-9;1864
28/11/2015;Torino FC;1942;5;1947;2 - 0;2;0;1;66;20;14;Bologna FC;1768;-5;1763
22/11/2015;Hellas Verona;1811;-7;1804;0 - 2;0;2;2;19;24;57;SSC Napoli;2104;7;2111
22/11/2015;ACF Fiorentina;2050;-7;2043;2 - 2;2;2;X;70;18;12;Empoli FC;1839;7;1846
22/11/2015;Lazio Roma;2011;-6;2005;1 - 1;1;1;X;64;21;15;US Palermo;1862;6;1868
22/11/2015;Genoa CFC;1920;7;1927;2 - 1;2;1;1;46;28;26;Sassuolo Calcio;1918;-7;1911
22/11/2015;Atalanta;1858;-11;1847;0 - 1;0;1;2;38;29;33;Torino FC;1931;11;1942
22/11/2015;Inter;2015;4;2019;4 - 0;4;0;1;77;15;8;Frosinone Calcio;1723;-4;1719
22/11/2015;Udinese Calcio;1833;9;1842;1 - 0;1;0;1;41;29;30;Sampdoria;1882;-9;1873
22/11/2015;Carpi FC;1738;-10;1728;1 - 2;1;2;2;34;29;37;Chievo Verona;1853;10;1863
21/11/2015;Juventus;2194;3;2197;1 - 0;1;0;1;71;18;11;AC Milan;1968;-3;1965
21/11/2015;Bologna FC;1763;5;1768;2 - 2;2;2;X;19;24;57;AS Roma;2056;-5;2051
08/11/2015;AS Roma;2046;10;2056;2 - 0;2;0;1;49;27;24;Lazio Roma;2021;-10;2011
08/11/2015;Empoli FC;1845;-6;1839;1 - 3;1;3;2;16;21;63;Juventus;2188;6;2194
08/11/2015;Torino FC;1942;-11;1931;0 - 1;0;1;2;39;29;32;Inter;2004;11;2015
08/11/2015;SSC Napoli;2102;2;2104;1 - 0;1;0;1;75;16;9;Udinese Calcio;1835;-2;1833
08/11/2015;Sampdoria;1895;-13;1882;0 - 2;0;2;2;31;29;40;ACF Fiorentina;2037;13;2050
08/11/2015;US Palermo;1855;7;1862;1 - 0;1;0;1;46;28;26;Chievo Verona;1860;-7;1853
08/11/2015;Sassuolo Calcio;1915;3;1918;1 - 0;1;0;1;66;20;14;Carpi FC;1741;-3;1738
08/11/2015;Frosinone Calcio;1720;3;1723;2 - 2;2;2;X;26;28;47;Genoa CFC;1923;-3;1920
07/11/2015;AC Milan;1974;-6;1968;0 - 0;0;0;X;61;23;17;Atalanta;1852;6;1858
07/11/2015;Hellas Verona;1834;-23;1811;0 - 2;0;2;2;57;24;19;Bologna FC;1740;23;1763
02/11/2015;Chievo Verona;1862;-2;1860;1 - 1;1;1;X;43;29;29;Sampdoria;1893;2;1895
02/11/2015;US Palermo;1869;-14;1855;0 - 1;0;1;2;51;26;23;Empoli FC;1831;14;1845
01/11/2015;Genoa CFC;1921;2;1923;0 - 0;0;0;X;28;28;44;SSC Napoli;2100;-2;2098
01/11/2015;Lazio Roma;2028;-22;2006;1 - 3;1;3;2;55;25;20;AC Milan;1952;22;1974
01/11/2015;Udinese Calcio;1836;-1;1835;0 - 0;0;0;X;38;29;33;Sassuolo Calcio;1914;1;1915
01/11/2015;ACF Fiorentina;2026;3;2029;4 - 1;4;1;1;78;15;8;Frosinone Calcio;1723;-3;1720
01/11/2015;Bologna FC;1720;20;1740;3 - 0;3;0;1;30;29;41;Atalanta;1872;-20;1852
01/11/2015;Carpi FC;1741;0;1741;0 - 0;0;0;X;36;29;35;Hellas Verona;1834;0;1834
31/10/2015;Juventus;2187;2;2189;2 - 1;2;1;1;73;17;10;Torino FC;1944;-2;1942
31/10/2015;Inter;1996;8;2004;1 - 0;1;0;1;41;29;30;AS Roma;2043;-8;2035
29/10/2015;Sampdoria;1898;-5;1893;1 - 1;1;1;X;55;25;20;Empoli FC;1826;5;1831
28/10/2015;Sassuolo Calcio;1899;15;1914;1 - 0;1;0;1;18;23;59;Juventus;2202;-15;2187
28/10/2015;SSC Napoli;2096;4;2100;2 - 0;2;0;1;71;18;11;US Palermo;1873;-4;1869
28/10/2015;Atalanta;1860;12;1872;2 - 1;2;1;1;28;28;44;Lazio Roma;2040;-12;2028
28/10/2015;AS Roma;2038;5;2043;3 - 1;3;1;1;69;19;12;Udinese Calcio;1841;-5;1836
28/10/2015;Torino FC;1948;-4;1944;3 - 3;3;3;X;50;27;23;Genoa CFC;1917;4;1921
28/10/2015;Hellas Verona;1846;-12;1834;0 - 2;0;2;2;29;29;43;ACF Fiorentina;2014;12;2026
28/10/2015;AC Milan;1947;5;1952;1 - 0;1;0;1;56;25;20;Chievo Verona;1867;-5;1862
28/10/2015;Frosinone Calcio;1715;8;1723;2 - 1;2;1;1;42;29;29;Carpi FC;1749;-8;1741
27/10/2015;Bologna FC;1726;-6;1720;0 - 1;0;1;2;21;25;54;Inter;1990;6;1996
25/10/2015;Juventus;2200;2;2202;2 - 0;2;0;1;80;14;6;Atalanta;1862;-2;1860
25/10/2015;ACF Fiorentina;2027;-13;2014;1 - 2;1;2;2;46;28;26;AS Roma;2025;13;2038
25/10/2015;Lazio Roma;2031;9;2040;3 - 0;3;0;1;55;25;20;Torino FC;1957;-9;1948
25/10/2015;Chievo Verona;1874;-7;1867;0 - 1;0;1;2;25;27;48;SSC Napoli;2089;7;2096
25/10/2015;AC Milan;1941;6;1947;2 - 1;2;1;1;50;26;23;Sassuolo Calcio;1905;-6;1899
25/10/2015;Sampdoria;1887;11;1898;4 - 1;4;1;1;50;27;24;Hellas Verona;1857;-11;1846
25/10/2015;Udinese Calcio;1837;4;1841;1 - 0;1;0;1;60;23;17;Frosinone Calcio;1719;-4;1715
24/10/2015;US Palermo;1872;1;1873;1 - 1;1;1;X;33;29;37;Inter;1991;-1;1990
24/10/2015;Empoli FC;1810;16;1826;2 - 0;2;0;1;33;29;38;Genoa CFC;1933;-16;1917
24/10/2015;Carpi FC;1763;-14;1749;1 - 2;1;2;2;52;26;22;Bologna FC;1712;14;1726
18/10/2015;Inter;1987;4;1991;0 - 0;0;0;X;24;27;50;Juventus;2215;-4;2211
18/10/2015;SSC Napoli;2067;7;2074;2 - 1;2;1;1;47;27;25;ACF Fiorentina;2058;-7;2051
18/10/2015;Sassuolo Calcio;1894;11;1905;2 - 1;2;1;1;31;29;40;Lazio Roma;2036;-11;2025
18/10/2015;Genoa CFC;1927;6;1933;3 - 2;3;2;1;52;26;22;Chievo Verona;1880;-6;1874
18/10/2015;Hellas Verona;1861;-4;1857;1 - 1;1;1;X;50;27;24;Udinese Calcio;1833;4;1837
18/10/2015;Atalanta;1853;9;1862;3 - 0;3;0;1;56;25;20;Carpi FC;1772;-9;1763
18/10/2015;Frosinone Calcio;1699;20;1719;2 - 0;2;0;1;25;27;47;Sampdoria;1907;-20;1887
18/10/2015;Bologna FC;1721;-9;1712;0 - 1;0;1;2;31;29;40;US Palermo;1863;9;1872
17/10/2015;Torino FC;1960;-3;1957;1 - 1;1;1;X;49;27;24;AC Milan;1938;3;1941
17/10/2015;AS Roma;2016;4;2020;3 - 1;3;1;1;69;19;12;Empoli FC;1814;-4;1810
04/10/2015;AC Milan;1957;-19;1938;0 - 4;0;4;2;36;29;34;SSC Napoli;2048;19;2067
04/10/2015;Juventus;2214;1;2215;3 - 1;3;1;1;87;10;3;Bologna FC;1722;-1;1721
04/10/2015;ACF Fiorentina;2053;5;2058;3 - 0;3;0;1;68;19;13;Atalanta;1858;-5;1853
04/10/2015;Sampdoria;1908;-1;1907;1 - 1;1;1;X;38;29;33;Inter;1986;1;1987
04/10/2015;US Palermo;1877;-14;1863;2 - 4;2;4;2;33;29;38;AS Roma;2002;14;2016
04/10/2015;Udinese Calcio;1833;0;1833;1 - 1;1;1;X;36;29;35;Genoa CFC;1927;0;1927
04/10/2015;Lazio Roma;2034;2;2036;2 - 0;2;0;1;80;14;7;Frosinone Calcio;1701;-2;1699
04/10/2015;Empoli FC;1804;10;1814;1 - 0;1;0;1;35;29;35;Sassuolo Calcio;1904;-10;1894
03/10/2015;Chievo Verona;1884;-4;1880;1 - 1;1;1;X;49;27;24;Hellas Verona;1857;4;1861
03/10/2015;Carpi FC;1759;13;1772;2 - 1;2;1;1;25;27;48;Torino FC;1973;-13;1960
28/09/2015;Atalanta;1849;9;1858;2 - 1;2;1;1;39;29;32;Sampdoria;1917;-9;1908
28/09/2015;Frosinone Calcio;1684;17;1701;2 - 0;2;0;1;32;29;39;Empoli FC;1821;-17;1804
27/09/2015;Inter;2008;-22;1986;1 - 4;1;4;2;45;28;27;ACF Fiorentina;2021;22;2043
27/09/2015;Hellas Verona;1865;-8;1857;1 - 2;1;2;2;30;29;41;Lazio Roma;2020;8;2028
27/09/2015;Genoa CFC;1919;8;1927;1 - 0;1;0;1;41;29;30;AC Milan;1965;-8;1957
27/09/2015;Torino FC;1968;5;1973;2 - 1;2;1;1;56;24;19;US Palermo;1882;-5;1877
27/09/2015;Sassuolo Calcio;1907;-3;1904;1 - 1;1;1;X;49;27;24;Chievo Verona;1881;3;1884
27/09/2015;Bologna FC;1732;-10;1722;1 - 2;1;2;2;36;29;34;Udinese Calcio;1823;10;1833
26/09/2015;SSC Napoli;2023;13;2036;2 - 1;2;1;1;27;28;46;Juventus;2217;-13;2204
26/09/2015;AS Roma;2019;4;2023;5 - 1;5;1;1;74;16;10;Carpi FC;1763;-4;1759
24/09/2015;Empoli FC;1834;-13;1821;0 - 1;0;1;2;46;28;26;Atalanta;1836;13;1849
23/09/2015;Lazio Roma;2012;8;2020;2 - 0;2;0;1;56;24;19;Genoa CFC;1927;-8;1919
23/09/2015;Sampdoria;1906;11;1917;2 - 1;2;1;1;33;29;38;AS Roma;2030;-11;2019
23/09/2015;Juventus;2227;-10;2217;1 - 1;1;1;X;88;10;2;Frosinone Calcio;1674;10;1684
23/09/2015;Inter;2004;4;2008;1 - 0;1;0;1;62;22;16;Hellas Verona;1869;-4;1865
23/09/2015;Chievo Verona;1871;10;1881;1 - 0;1;0;1;35;29;36;Torino FC;1978;-10;1968
23/09/2015;US Palermo;1895;-13;1882;0 - 1;0;1;2;46;28;26;Sassuolo Calcio;1894;13;1907
23/09/2015;Carpi FC;1758;5;1763;0 - 0;0;0;X;21;25;55;SSC Napoli;2028;-5;2023
23/09/2015;ACF Fiorentina;2018;3;2021;2 - 0;2;0;1;76;15;8;Bologna FC;1735;-3;1732
22/09/2015;Udinese Calcio;1832;-9;1823;2 - 3;2;3;2;33;29;38;AC Milan;1956;9;1965
20/09/2015;Genoa CFC;1935;-8;1927;0 - 2;0;2;2;20;24;56;Juventus;2219;8;2227
20/09/2015;SSC Napoli;2013;15;2028;5 - 0;5;0;1;45;28;27;Lazio Roma;2027;-15;2012
20/09/2015;AS Roma;2036;-6;2030;2 - 2;2;2;X;63;21;15;Sassuolo Calcio;1888;6;1894
20/09/2015;Torino FC;1969;9;1978;2 - 0;2;0;1;53;26;22;Sampdoria;1915;-9;1906
20/09/2015;Chievo Verona;1881;-10;1871;0 - 1;0;1;2;34;29;37;Inter;1994;10;2004
20/09/2015;Carpi FC;1764;-6;1758;0 - 1;0;1;2;22;26;52;ACF Fiorentina;2012;6;2018
20/09/2015;Atalanta;1838;-2;1836;1 - 1;1;1;X;43;29;29;Hellas Verona;1867;2;1869
20/09/2015;Bologna FC;1729;6;1735;1 - 0;1;0;1;52;26;22;Frosinone Calcio;1680;-6;1674
19/09/2015;AC Milan;1950;6;1956;3 - 2;3;2;1;52;26;22;US Palermo;1901;-6;1895
19/09/2015;Udinese Calcio;1845;-13;1832;1 - 2;1;2;2;49;27;24;Empoli FC;1821;13;1834
14/09/2015;Sampdoria;1910;5;1915;2 - 0;2;0;1;66;20;14;Bologna FC;1734;-5;1729
13/09/2015;Inter;1988;6;1994;1 - 0;1;0;1;50;27;23;AC Milan;1956;-6;1950
13/09/2015;Lazio Roma;2021;5;2026;2 - 0;2;0;1;66;20;14;Udinese Calcio;1850;-5;1845
13/09/2015;Hellas Verona;1867;0;1867;2 - 2;2;2;X;35;29;35;Torino FC;1969;0;1969
13/09/2015;Empoli FC;1819;2;1821;2 - 2;2;2;X;27;28;45;SSC Napoli;2005;-2;2003
13/09/2015;Sassuolo Calcio;1892;-4;1888;2 - 2;2;2;X;53;26;21;Atalanta;1834;4;1838
13/09/2015;US Palermo;1907;-6;1901;2 - 2;2;2;X;64;21;15;Carpi FC;1758;6;1764
12/09/2015;Juventus;2210;-9;2201;1 - 1;1;1;X;80;14;6;Chievo Verona;1872;9;1881
12/09/2015;ACF Fiorentina;2024;5;2029;1 - 0;1;0;1;56;24;19;Genoa CFC;1940;-5;1935
12/09/2015;Frosinone Calcio;1686;-6;1680;0 - 2;0;2;2;16;22;62;AS Roma;2021;6;2027
30/08/2015;AS Roma;2008;13;2021;2 - 1;2;1;1;25;27;48;Juventus;2223;-13;2210
30/08/2015;Torino FC;1955;14;1969;3 - 1;3;1;1;37;29;34;ACF Fiorentina;2038;-14;2024
30/08/2015;SSC Napoli;2010;-5;2005;2 - 2;2;2;X;59;23;18;Sampdoria;1905;5;1910
30/08/2015;Chievo Verona;1848;24;1872;4 - 0;4;0;1;26;28;46;Lazio Roma;2045;-24;2021
30/08/2015;Genoa CFC;1931;9;1940;2 - 0;2;0;1;53;26;22;Hellas Verona;1876;-9;1867
30/08/2015;Udinese Calcio;1862;-12;1850;0 - 1;0;1;2;42;29;29;US Palermo;1895;12;1907
30/08/2015;Carpi FC;1765;-7;1758;1 - 2;1;2;2;25;27;48;Inter;1981;7;1988
30/08/2015;Atalanta;1828;6;1834;2 - 0;2;0;1;62;22;16;Frosinone Calcio;1692;-6;1686
29/08/2015;AC Milan;1952;4;1956;2 - 1;2;1;1;61;22;16;Empoli FC;1823;-4;1819
29/08/2015;Bologna FC;1743;-9;1734;0 - 1;0;1;2;31;29;40;Sassuolo Calcio;1883;9;1892
23/08/2015;Juventus;2242;-19;2223;0 - 1;0;1;2;83;12;5;Udinese Calcio;1843;19;1862
23/08/2015;ACF Fiorentina;2030;8;2038;2 - 0;2;0;1;55;25;20;AC Milan;1960;-8;1952
23/08/2015;Sassuolo Calcio;1872;11;1883;2 - 1;2;1;1;31;29;40;SSC Napoli;2021;-11;2010
23/08/2015;US Palermo;1886;9;1895;1 - 0;1;0;1;40;29;31;Genoa CFC;1940;-9;1931
23/08/2015;Inter;1977;4;1981;1 - 0;1;0;1;63;21;15;Atalanta;1832;-4;1828
23/08/2015;Empoli FC;1843;-20;1823;1 - 3;1;3;2;48;27;25;Chievo Verona;1828;20;1848
23/08/2015;Sampdoria;1897;8;1905;5 - 2;5;2;1;61;22;17;Carpi FC;1773;-8;1765
23/08/2015;Frosinone Calcio;1698;-6;1692;1 - 2;1;2;2;22;26;52;Torino FC;1949;6;1955
22/08/2015;Hellas Verona;1875;1;1876;1 - 1;1;1;X;32;29;39;AS Roma;2009;-1;2008
22/08/2015;Lazio Roma;2058;2;2060;2 - 1;2;1;1;78;14;7;Bologna FC;1745;-2;1743
